O O O O O O O O O O O O O O O O O O O O O O O O O O O O O O O B-OBJ I-OBJ I-OBJ I-OBJ I-OBJ I-OBJ I-OBJ O O O O O O O O O O B-SUB I-SUB I-SUB I-SUB I-SUB I-SUB O O O O O O O O O O O	采访
B-OBJ I-OBJ O O O O O O O O B-SUB I-SUB O O O O O O	地理
B-OBJ I-OBJ O B-SUB I-SUB I-SUB I-SUB I-SUB I-SUB I-SUB	地理
B-OBJ I-OBJ O O B-SUB I-SUB I-SUB O O O O O O	地理
O B-OBJ I-OBJ B-SUB I-SUB I-SUB O O O O O O O O	地理
O O O O O O O B-OBJ I-OBJ I-OBJ I-OBJ I-OBJ I-OBJ O B-SUB I-SUB I-SUB I-SUB I-SUB I-SUB	地理
B-OBJ I-OBJ B-SUB I-SUB I-SUB I-SUB I-SUB O O O O O O O O O O O O	地理
B-OBJ I-OBJ B-SUB I-SUB I-SUB I-SUB I-SUB O O O O O O O O O O O O O O O O O O O O O O O	地理
B-OBJ I-OBJ B-SUB I-SUB I-SUB I-SUB I-SUB I-SUB O O O O O O O O O O O O O O O	地理
B-OBJ I-OBJ B-SUB I-SUB I-SUB I-SUB O O O O O O O O O O O O O O O O O O O O O	地理
B-OBJ I-OBJ O O O O O O O B-SUB I-SUB I-SUB O O O O O O O O O O O O O	地理
B-OBJ I-OBJ O O O O O O O O O O O B-SUB I-SUB I-SUB O O O O O O O O O	地理
B-OBJ I-OBJ O O O O O O O O O O O O O O O O O O O O O O O O B-SUB I-SUB I-SUB O O O O O O O O O O O O O O O O O O O O	地理
O B-OBJ I-OBJ O O O B-SUB I-SUB I-SUB I-SUB I-SUB	地理
B-OBJ I-OBJ O O O O O O B-SUB I-SUB I-SUB I-SUB O O O O O O O O O O O O O O O O O O O O	地理
B-SUB I-SUB O O O O B-OBJ I-OBJ O O O O O O O	地理
B-OBJ I-OBJ B-SUB I-SUB I-SUB I-SUB I-SUB I-SUB I-SUB I-SUB I-SUB I-SUB O O O O	地理
B-OBJ I-OBJ O O O O O O O O O O O B-SUB I-SUB I-SUB I-SUB I-SUB I-SUB	地理
B-OBJ I-OBJ I-SUB I-SUB I-SUB I-SUB I-SUB I-SUB I-SUB O O	地理
B-OBJ I-OBJ I-SUB I-SUB I-SUB I-SUB I-SUB I-SUB I-SUB I-SUB I-SUB O O O O O O O	地理
B-OBJ I-OBJ I-SUB I-SUB I-SUB I-SUB I-SUB O O O O O O O	地理
B-SUB I-SUB O O O O O O O O O O O [##WordPiece] O O O O B-OBJ I-OBJ O O	地理
B-OBJ I-OBJ I-SUB I-SUB I-SUB I-SUB I-SUB I-SUB O O O O O O [##WordPiece] [##WordPiece] O O O O O O O O O O O O	地理
B-OBJ I-OBJ I-SUB I-SUB I-SUB O O O O O O O O	地理
O O O O O O O O B-OBJ I-OBJ I-SUB I-SUB O O O O O O O O O O O O O O O O	地理
O B-OBJ I-OBJ O O O O O O O O O O O O O O O O O O O O O O O O O O O B-SUB I-SUB I-SUB I-SUB I-SUB I-SUB O O O O O O	地理
O O O O O O O O O O O O O O O O B-SUB I-SUB I-SUB O O O O O O O O B-OBJ I-OBJ	地理
B-OBJ I-OBJ B-SUB I-SUB I-SUB O O O O O O O O O O O O O O O O O O O O	地理
B-OBJ I-OBJ I-SUB I-SUB I-SUB I-SUB I-SUB O O O	地理
B-OBJ I-OBJ B-SUB I-SUB I-SUB I-SUB I-SUB I-SUB I-SUB I-SUB I-SUB I-SUB O O O O O O O O O O	地理
B-OBJ I-OBJ B-SUB I-SUB I-SUB I-SUB O O O O O O O O O O O O	地理
B-OBJ I-OBJ O O O O B-SUB I-SUB I-SUB I-SUB I-SUB I-SUB I-SUB I-SUB O O O O O O O	地理
B-OBJ I-OBJ B-SUB I-SUB I-SUB I-SUB I-SUB O O O O O O O O O O O	地理
O O B-OBJ I-OBJ B-SUB I-SUB I-SUB I-SUB I-SUB I-SUB I-SUB I-SUB I-SUB I-SUB I-SUB I-SUB O O O O O O O O O O O O O	地理
O O O O B-OBJ I-OBJ I-SUB I-SUB I-SUB I-SUB I-SUB I-SUB I-SUB O O O O O O O O O	地理
B-OBJ I-OBJ I-SUB I-SUB I-SUB I-SUB I-SUB I-SUB I-SUB O O [##WordPiece] O O O O O O O O O	地理
B-OBJ I-OBJ O O O O O O O O O O O O O O O O O O O O O O O O O O O O O O B-SUB I-SUB I-SUB I-SUB I-SUB I-SUB O O O O	地理
B-OBJ I-OBJ I-SUB I-SUB I-SUB O O O O O O O O O O O O	地理
O O O O O O O O O O O O O O O B-OBJ I-OBJ B-SUB I-SUB O O O O O O O	地理
B-SUB I-SUB O O O O B-OBJ I-OBJ O O O O O O O	地理
B-OBJ I-OBJ I-SUB I-SUB I-SUB I-SUB I-SUB I-SUB O O O O O O O	地理
O O O O O O O B-OBJ I-OBJ B-SUB I-SUB I-SUB I-SUB I-SUB O O O O O O O O	地理
B-OBJ I-OBJ B-SUB I-SUB I-SUB O O O O O O O O O O O O O O O O O O O O O O O O O	地理
B-OBJ I-OBJ I-SUB I-SUB I-SUB I-SUB I-SUB I-SUB I-SUB I-SUB I-SUB I-SUB O O O O	地理
O O O O O O O B-SUB I-SUB O O O O O O O O O O O O O O O O O O B-OBJ I-OBJ O O O O	地理
B-SUB I-SUB O O O O B-OBJ I-OBJ O O	地理
B-OBJ I-OBJ O O O O O O O O O O O O O O O O B-SUB I-SUB I-SUB I-SUB O O O O O O O O O O O O O	地理
B-SUB I-SUB O O O B-OBJ I-OBJ O O O	地理
B-SUB I-SUB O B-OBJ I-OBJ O O O O O O O O O O O O	地理
B-OBJ I-OBJ I-SUB I-SUB I-SUB I-SUB O O O O O O O O O O O O	地理
O O O O O O O B-OBJ I-OBJ I-SUB I-SUB I-SUB O O O O O O O O O O O O O O O O O	地理
O O O O O O O B-OBJ I-OBJ O O O O B-SUB I-SUB I-SUB I-SUB I-SUB I-SUB O O O O O O O O O O	地理
O O O O O O O B-OBJ I-OBJ O O O O O O O O O O O B-SUB I-SUB I-SUB I-SUB I-SUB I-SUB I-SUB O O	地理
O O O O O O B-OBJ I-OBJ I-SUB I-SUB I-SUB O O	地理
B-OBJ I-OBJ O O O O O O O O O O O O O O B-SUB I-SUB I-SUB I-SUB I-SUB I-SUB I-SUB O O	地理
O B-OBJ I-OBJ I-SUB I-SUB I-SUB I-SUB O O O O O O O O O O O O O O O O O O O O O O O O O O O O O O O O O O O O	地理
O B-OBJ I-OBJ O O O O O O O O O O O O O O O O O O O O O B-SUB I-SUB I-SUB O O O O O O O O O O O O O O O O O O O O O O O O O	地理
B-OBJ I-OBJ I-OBJ B-SUB I-SUB I-SUB I-SUB O O O O O O O O O O O O O O O O O O O O O	地理
B-OBJ I-OBJ I-SUB I-SUB I-SUB I-SUB I-SUB O O O O O O O O O O O O O O O O O O O O O O O O O O O	地理
B-OBJ I-OBJ B-SUB I-SUB I-SUB O O O O O O O O O O O O O O O O O O O O O O	地理
O O O O O O O O B-OBJ I-OBJ B-SUB I-SUB I-SUB O O O O O O O O O O O O O O O O O O O O O O	地理
B-OBJ I-OBJ I-SUB I-SUB I-SUB I-SUB I-SUB I-SUB I-SUB I-SUB O O O O O O O O O O O O O	地理
O O O O O O O O O O O O O B-OBJ I-OBJ I-OBJ I-OBJ I-OBJ I-OBJ O B-SUB I-SUB I-SUB I-SUB I-SUB I-SUB I-SUB O O O O O O O O O O O O O O O O O O O [##WordPiece] [##WordPiece] O O O O O O O O O	地理
O B-OBJ I-OBJ O O B-SUB I-SUB I-SUB O O O O O O O O O O O O O O O O O O O	地理
O O O O B-OBJ I-OBJ O O O O O O O O B-SUB [##WordPiece] O O O O O O O O O O O O O O O O O O O O O O O O O O O O O O O O O O O O O O O O O O O O O	地理
O O O O O O O O O O O B-OBJ I-OBJ B-SUB I-SUB I-SUB I-SUB I-SUB I-SUB I-SUB O O O O O O O O O O O O O O O O O O O O O O O O O O O O O O O O O O O O O O O O O O O O O O	地理
B-OBJ I-OBJ B-SUB I-SUB I-SUB I-SUB I-SUB I-SUB I-SUB I-SUB O O O O O O O O O O O O O O O O O O O O O O O O O	地理
O O B-OBJ I-OBJ I-OBJ B-SUB I-SUB I-SUB I-SUB I-SUB I-SUB I-SUB I-SUB	地理
B-OBJ I-OBJ B-SUB I-SUB I-SUB I-SUB I-SUB I-SUB O O O O O O O O O O O O O O O O O O O O O O	地理
O B-OBJ I-OBJ I-OBJ B-SUB I-SUB O O	地理
B-OBJ I-OBJ O O O O O O O O O O O O O O O O O O O O O O O O O O O O O O O O O B-SUB I-SUB I-SUB I-SUB I-SUB I-SUB O O O O O	地理
O B-OBJ I-OBJ O O B-SUB I-SUB I-SUB O O	地理
O O O O O B-OBJ I-OBJ I-OBJ O O O B-SUB I-SUB I-SUB I-SUB I-SUB I-SUB I-SUB I-SUB	地理
O B-OBJ I-OBJ I-OBJ I-OBJ I-OBJ O O B-SUB I-SUB I-SUB I-SUB	地理
O O O O O O B-OBJ I-OBJ B-SUB I-SUB I-SUB	地理
B-OBJ I-OBJ I-OBJ O O B-SUB I-SUB I-SUB I-SUB	地理
B-OBJ I-OBJ I-OBJ I-OBJ B-SUB I-SUB I-SUB I-SUB I-SUB I-SUB I-SUB	地理
B-OBJ I-OBJ O O O O O O O O O O O B-SUB I-SUB I-SUB I-SUB I-SUB I-SUB O O O O O O O O O O O O O O O O O O O O O	地理
O O O O O O O B-OBJ I-OBJ I-OBJ B-SUB I-SUB I-SUB O O O O O O O O O O O O O	地理
O O O O O O O O O O O O O O O O B-OBJ I-OBJ I-SUB I-SUB I-SUB I-SUB I-SUB I-SUB I-SUB O	地理
O O O O O O O O O O O O O O O B-OBJ I-OBJ O O B-SUB I-SUB O O O O O O O O	地理
O O O O O O B-OBJ I-OBJ O O B-SUB I-SUB	地理
O O B-OBJ I-OBJ B-SUB I-SUB I-SUB I-SUB I-SUB I-SUB O O O O O O O	地理
O O O O O O O O O O B-OBJ I-OBJ O O O O O O O O O B-SUB I-SUB I-SUB I-SUB I-SUB O O O O O	地理
B-OBJ I-OBJ B-SUB I-SUB I-SUB I-SUB O O O O O O O O O O O O O O O O O O O O O O	地理
O O B-OBJ I-OBJ I-OBJ I-OBJ B-SUB I-SUB I-SUB I-SUB I-SUB O O O O O O O O O O O O O O O O O	地理
B-OBJ I-OBJ B-SUB I-SUB I-SUB I-SUB I-SUB O O O O O O O O O O O O O O O O O O O O O O O O O O O	地理
B-OBJ I-OBJ I-OBJ I-OBJ I-OBJ O O O O B-SUB I-SUB O O [##WordPiece] [##WordPiece] O [##WordPiece] [##WordPiece] O O O O O O O O O O O	地理
B-OBJ I-OBJ O B-SUB I-SUB I-SUB I-SUB I-SUB I-SUB I-SUB	地理
B-OBJ I-OBJ B-SUB I-SUB I-SUB	地理
B-OBJ I-OBJ B-SUB I-SUB I-SUB I-SUB I-SUB O O O O	地理
B-SUB I-SUB O B-OBJ I-OBJ O O O O O O O O O O O O	地理
O B-OBJ I-OBJ O O B-SUB I-SUB O O O O O	地理
B-SUB I-SUB O O O O B-OBJ I-OBJ O O O O O O O	地理
B-OBJ I-OBJ B-SUB I-SUB I-SUB I-SUB I-SUB O O O	地理
B-OBJ I-OBJ B-SUB I-SUB I-SUB	地理
B-OBJ I-OBJ B-SUB I-SUB	地理
B-OBJ I-OBJ B-SUB I-SUB I-SUB I-SUB I-SUB I-SUB I-SUB I-SUB I-SUB I-SUB	地理
B-OBJ I-OBJ B-SUB I-SUB I-SUB I-SUB I-SUB I-SUB I-SUB	地理
B-OBJ I-OBJ O O O O O B-SUB I-SUB I-SUB I-SUB I-SUB I-SUB I-SUB	地理
B-OBJ I-OBJ B-SUB I-SUB I-SUB I-SUB O O	地理
B-SUB I-SUB I-SUB O O O O O O O O O O O O O O B-OBJ I-OBJ O O O O	地理
B-OBJ I-OBJ B-SUB I-SUB I-SUB I-SUB I-SUB I-SUB I-SUB O O O O O	地理
B-OBJ I-OBJ O O B-SUB I-SUB I-SUB I-SUB I-SUB I-SUB I-SUB I-SUB I-SUB I-SUB	地理
B-OBJ I-OBJ B-SUB I-SUB I-SUB I-SUB I-SUB	地理
B-OBJ I-OBJ B-SUB I-SUB I-SUB I-SUB I-SUB I-SUB I-SUB	地理
B-OBJ I-OBJ B-SUB I-SUB I-SUB I-SUB I-SUB I-SUB I-SUB I-SUB	地理
B-OBJ I-OBJ B-SUB I-SUB I-SUB	地理
O O B-OBJ I-OBJ O O O O O O B-SUB I-SUB I-SUB I-SUB I-SUB I-SUB O O O	地理
B-OBJ I-OBJ O O O B-SUB I-SUB I-SUB I-SUB I-SUB	地理
B-OBJ I-OBJ B-SUB I-SUB I-SUB I-SUB I-SUB I-SUB I-SUB	地理
B-OBJ I-OBJ B-SUB I-SUB I-SUB I-SUB I-SUB I-SUB	地理
B-OBJ I-OBJ B-SUB I-SUB I-SUB I-SUB I-SUB I-SUB	地理
B-OBJ I-OBJ B-SUB I-SUB I-SUB I-SUB I-SUB I-SUB	地理
B-OBJ I-OBJ B-SUB I-SUB I-SUB I-SUB I-SUB	地理
B-OBJ I-OBJ B-SUB I-SUB I-SUB I-SUB I-SUB I-SUB	地理
B-OBJ I-OBJ B-SUB I-SUB I-SUB	地理
B-SUB I-SUB O O O O B-OBJ I-OBJ O O O O O O O	地理
B-SUB I-SUB O O O O O O O O O O O O O O O O O O O O B-OBJ I-OBJ O O O O O O O O O O O O O	地理
B-OBJ I-OBJ O B-SUB I-SUB O O O O O O O O O O O	地理
B-SUB I-SUB O B-OBJ I-OBJ O O O O O O O O O	地理
B-SUB I-SUB O O O O B-OBJ I-OBJ O O O O O O O	地理
B-SUB I-SUB O B-OBJ I-OBJ O O O O O O O O O O	地理
O O B-SUB I-SUB O O O O O O O B-OBJ I-OBJ O O O O O O O O O O	地理
B-SUB I-SUB O B-OBJ I-OBJ O O O O O O O O	地理
B-OBJ I-OBJ B-SUB I-SUB I-SUB I-SUB I-SUB I-SUB I-SUB I-SUB I-SUB I-SUB O O O O O O O O O O O O O O O O O O O O O O O O O O O O O O O O O O	地理
B-OBJ I-OBJ O O O O O O O O O O O B-SUB I-SUB I-SUB I-SUB I-SUB I-SUB I-SUB I-SUB I-SUB I-SUB I-SUB O O O O O O O O O O O O O O O O O O O O O O	地理
B-OBJ I-OBJ B-SUB I-SUB I-SUB O O O O O O O O O O O O O O O O O O O O O	地理
B-OBJ I-OBJ B-SUB I-SUB I-SUB O O O O O O O O O O	地理
B-OBJ I-OBJ B-SUB I-SUB O O O O O O O O O O O O O O O O O O O O O O	地理
O O O O O B-OBJ I-OBJ O O O O O B-SUB I-SUB I-SUB O O O O O O O O O O O O O O O O O O O O	地理
B-OBJ I-OBJ B-SUB I-SUB I-SUB I-SUB I-SUB I-SUB I-SUB O O O O O O O O O O O O O O O	地理
B-OBJ I-OBJ B-SUB I-SUB O O O O O O O O O O	地理
O O O O O O O O B-OBJ I-OBJ B-SUB I-SUB I-SUB O O O O O O O O O O O	地理
B-OBJ I-OBJ B-SUB I-SUB I-SUB I-SUB I-SUB O O O O O O O O O O O O O O O O O	地理
B-OBJ I-OBJ O O O O B-SUB I-SUB I-SUB O O O O O O O O O O O O O O	地理
B-OBJ I-OBJ B-SUB I-SUB I-SUB I-SUB I-SUB I-SUB I-SUB I-SUB O O O O O O O O O O	地理
B-OBJ I-OBJ B-SUB I-SUB I-SUB I-SUB I-SUB O O O O O O O O O O O [##WordPiece] O [##WordPiece] O O O O O O O O O O O O O O O O O O O O O	地理
B-OBJ I-OBJ I-OBJ O O O O O O O B-SUB I-SUB I-SUB I-SUB I-SUB I-SUB I-SUB	地理
B-OBJ I-OBJ B-SUB I-SUB O O O O O O O	地理
B-OBJ I-OBJ B-SUB I-SUB I-SUB I-SUB I-SUB O O O O O O O O O O O O O O O O O O O O O	地理
B-SUB I-SUB O O O O O O O O O O O O O O O O O O O O B-OBJ I-OBJ I-OBJ I-OBJ I-OBJ I-OBJ I-OBJ I-OBJ I-OBJ I-OBJ I-OBJ I-OBJ	发表
O O O O O O B-SUB I-SUB I-SUB O O O O O O O O O B-OBJ I-OBJ I-OBJ I-OBJ I-OBJ I-OBJ	发表
O O B-OBJ I-OBJ I-OBJ I-OBJ I-OBJ I-OBJ O O O O O O O O O O O O O O O O O O O O O O O O O O O O O O O O O O O O O O O O	发表
O O B-OBJ I-OBJ I-OBJ I-OBJ I-OBJ I-OBJ O O O O O O O O O O O O O O B-SUB I-SUB [##WordPiece] I-SUB I-SUB I-SUB I-SUB I-SUB I-SUB I-SUB I-SUB I-SUB I-SUB I-SUB I-SUB I-SUB I-SUB I-SUB I-SUB I-SUB I-SUB I-SUB O O O O	发表
O O B-OBJ I-OBJ I-OBJ I-OBJ I-OBJ I-OBJ O O O O O O O O O O O O O B-SUB I-SUB I-SUB I-SUB I-SUB I-SUB I-SUB I-SUB I-SUB I-SUB I-SUB I-SUB I-SUB I-SUB I-SUB I-SUB I-SUB I-SUB I-SUB I-SUB I-SUB I-SUB O O O O	发表
B-OBJ I-OBJ I-OBJ I-OBJ I-OBJ I-OBJ I-OBJ I-OBJ O O O O O O O O O B-SUB I-SUB I-SUB I-SUB I-SUB I-SUB I-SUB I-SUB I-SUB I-SUB I-SUB I-SUB I-SUB I-SUB I-SUB I-SUB I-SUB I-SUB I-SUB I-SUB I-SUB I-SUB I-SUB I-SUB I-SUB I-SUB I-SUB I-SUB I-SUB I-SUB I-SUB I-SUB O O O O	发表
O O O B-OBJ I-OBJ I-OBJ I-OBJ I-OBJ O O O O O O O O O O O B-SUB I-SUB I-SUB I-SUB I-SUB I-SUB I-SUB I-SUB I-SUB I-SUB I-SUB I-SUB I-SUB I-SUB I-SUB I-SUB I-SUB I-SUB I-SUB I-SUB I-SUB O O O O	发表
O O B-OBJ I-OBJ I-OBJ I-OBJ I-OBJ I-OBJ O O O O O O O O O B-SUB I-SUB I-SUB I-SUB I-SUB I-SUB I-SUB I-SUB I-SUB I-SUB I-SUB I-SUB I-SUB I-SUB I-SUB I-SUB I-SUB I-SUB I-SUB I-SUB I-SUB O O O O O	发表
B-OBJ I-OBJ I-OBJ I-OBJ I-OBJ I-OBJ I-OBJ O O O O O O O O O B-SUB I-SUB I-SUB I-SUB I-SUB I-SUB I-SUB I-SUB I-SUB I-SUB I-SUB I-SUB I-SUB I-SUB I-SUB I-SUB I-SUB I-SUB I-SUB I-SUB I-SUB I-SUB I-SUB I-SUB I-SUB I-SUB I-SUB I-SUB I-SUB I-SUB I-SUB I-SUB I-SUB I-SUB O O O O	发表
O O B-OBJ I-OBJ I-OBJ I-OBJ I-OBJ I-OBJ O O O O O O O O O O B-SUB I-SUB I-SUB I-SUB I-SUB I-SUB I-SUB I-SUB I-SUB I-SUB I-SUB I-SUB I-SUB I-SUB I-SUB I-SUB I-SUB I-SUB I-SUB I-SUB I-SUB O O O O	发表
O O O B-OBJ I-OBJ I-OBJ I-OBJ I-OBJ O O O O O O O O O O O B-SUB I-SUB I-SUB I-SUB I-SUB I-SUB I-SUB I-SUB I-SUB I-SUB I-SUB I-SUB I-SUB I-SUB I-SUB I-SUB I-SUB I-SUB I-SUB I-SUB I-SUB O O O O	发表
O O B-OBJ I-OBJ I-OBJ I-OBJ I-OBJ I-OBJ O O O O O O O O O O O O O O O O O O O O O O O O O O O O O O O O O O O O O O B-SUB I-SUB I-SUB I-SUB I-SUB I-SUB I-SUB I-SUB I-SUB I-SUB I-SUB I-SUB I-SUB I-SUB I-SUB I-SUB I-SUB I-SUB I-SUB I-SUB I-SUB I-SUB O O O O	发表
O O O O O O B-OBJ I-OBJ I-OBJ I-OBJ I-OBJ I-OBJ I-OBJ I-OBJ I-OBJ I-OBJ I-OBJ I-OBJ O O O O B-SUB I-SUB I-SUB I-SUB I-SUB I-SUB I-SUB	发表
O O B-OBJ I-OBJ I-OBJ I-OBJ O O O O O O O O O O O O O B-SUB I-SUB I-SUB I-SUB I-SUB I-SUB I-SUB I-SUB I-SUB I-SUB I-SUB I-SUB I-SUB I-SUB I-SUB I-SUB I-SUB O O O O	发表
B-OBJ I-OBJ I-OBJ I-OBJ I-OBJ I-OBJ O O O O O O O O O O O B-SUB I-SUB I-SUB I-SUB I-SUB I-SUB I-SUB I-SUB I-SUB I-SUB I-SUB I-SUB I-SUB I-SUB I-SUB I-SUB I-SUB I-SUB I-SUB I-SUB I-SUB I-SUB I-SUB I-SUB O O O O	发表
O O B-OBJ I-OBJ I-OBJ I-OBJ I-OBJ I-OBJ O O O O O O O O O O O B-SUB I-SUB I-SUB I-SUB I-SUB I-SUB I-SUB I-SUB I-SUB I-SUB I-SUB I-SUB I-SUB I-SUB I-SUB I-SUB I-SUB O O O	发表
B-OBJ I-OBJ I-OBJ I-OBJ I-OBJ I-OBJ I-OBJ I-OBJ O O O O O O O O O B-SUB I-SUB I-SUB I-SUB I-SUB I-SUB I-SUB I-SUB I-SUB I-SUB I-SUB I-SUB I-SUB I-SUB I-SUB I-SUB I-SUB I-SUB I-SUB I-SUB I-SUB I-SUB I-SUB I-SUB I-SUB I-SUB I-SUB I-SUB I-SUB I-SUB I-SUB O O O	发表
O O B-OBJ I-OBJ I-OBJ I-OBJ I-OBJ I-OBJ O O O O O O O O O O O O O B-SUB I-SUB I-SUB I-SUB I-SUB I-SUB I-SUB I-SUB I-SUB I-SUB I-SUB I-SUB I-SUB I-SUB I-SUB I-SUB I-SUB I-SUB I-SUB I-SUB I-SUB I-SUB I-SUB O O O O	发表
O O O B-OBJ I-OBJ I-OBJ I-OBJ I-OBJ O O O O O O O O O O O O O B-SUB I-SUB I-SUB I-SUB I-SUB I-SUB I-SUB I-SUB I-SUB I-SUB I-SUB I-SUB I-SUB I-SUB I-SUB I-SUB I-SUB I-SUB O O O O	发表
O O O O B-OBJ I-OBJ I-OBJ I-OBJ I-OBJ I-OBJ O O O O O O O O O O O O O B-SUB I-SUB I-SUB I-SUB I-SUB I-SUB I-SUB I-SUB I-SUB I-SUB I-SUB I-SUB I-SUB I-SUB I-SUB I-SUB I-SUB I-SUB I-SUB I-SUB I-SUB I-SUB I-SUB I-SUB I-SUB I-SUB I-SUB I-SUB O O O	发表
O B-OBJ I-OBJ I-OBJ I-OBJ I-OBJ I-OBJ O O O O O O O O O O B-SUB I-SUB I-SUB I-SUB I-SUB I-SUB I-SUB I-SUB I-SUB I-SUB O O O O O O	发表
O O B-OBJ I-OBJ I-OBJ I-OBJ I-OBJ I-OBJ O O O O O O O O O O O O B-SUB I-SUB I-SUB I-SUB I-SUB I-SUB I-SUB I-SUB I-SUB I-SUB I-SUB I-SUB I-SUB I-SUB I-SUB I-SUB I-SUB I-SUB I-SUB I-SUB I-SUB I-SUB I-SUB I-SUB I-SUB I-SUB I-SUB I-SUB I-SUB I-SUB I-SUB I-SUB I-SUB I-SUB O O O	发表
B-OBJ I-OBJ I-OBJ I-OBJ I-OBJ I-OBJ O O O O O O O O O O O B-SUB I-SUB I-SUB I-SUB I-SUB I-SUB I-SUB I-SUB I-SUB I-SUB I-SUB I-SUB I-SUB I-SUB I-SUB I-SUB I-SUB I-SUB I-SUB I-SUB I-SUB I-SUB I-SUB I-SUB O O O	发表
O O B-OBJ I-OBJ I-OBJ I-OBJ I-OBJ I-OBJ O O O O O O O O O O O O O O B-SUB I-SUB I-SUB I-SUB I-SUB I-SUB I-SUB I-SUB I-SUB I-SUB I-SUB I-SUB I-SUB I-SUB I-SUB I-SUB I-SUB I-SUB I-SUB I-SUB O O O O	发表
B-SUB I-SUB O O O O O O O O O O O O O O B-OBJ I-OBJ I-OBJ I-OBJ I-OBJ I-OBJ I-OBJ O O O O O O	发表
O O O O O O B-SUB I-SUB I-SUB O O O B-OBJ I-OBJ O O O O O O O O O O O O O O	发表
O B-OBJ I-OBJ O O O O O O O O O O O O O O O O O O O B-SUB I-SUB O O O O O	发表
B-SUB I-SUB O O O O O O O O O O O O O O O O B-OBJ I-OBJ O O O O O O O O O O O O O O O O O O O O O O O O O O O O	发表
B-SUB I-SUB I-SUB I-SUB I-SUB I-SUB I-SUB I-SUB [##WordPiece] O O O O O O O O O O O O O O O O O O B-OBJ I-OBJ I-OBJ I-OBJ I-OBJ I-OBJ I-OBJ I-OBJ I-OBJ	发表
O O O O O O O O [##WordPiece] O O B-SUB I-SUB I-SUB I-SUB I-SUB I-SUB I-SUB I-SUB I-SUB I-SUB I-SUB I-SUB O O O O B-OBJ I-OBJ I-OBJ I-OBJ I-OBJ I-OBJ I-OBJ I-OBJ I-OBJ	发表
B-SUB I-SUB I-SUB O O O O O O O B-OBJ I-OBJ I-OBJ	攻击
O O O O O O O O O O O O O O O O O O O O O O O O B-SUB I-SUB I-SUB O O O O O B-OBJ I-OBJ I-OBJ	攻击
O O O O O O O O O B-SUB I-SUB O O O O O O O O B-OBJ I-OBJ	攻击
B-OBJ I-OBJ I-OBJ I-OBJ I-OBJ I-OBJ I-OBJ O O O O O O B-SUB I-SUB I-SUB O O O O O O	攻击
O O O O B-OBJ I-OBJ I-OBJ O O O O O O O O O O O O O O B-SUB I-SUB I-SUB I-SUB I-SUB I-SUB I-SUB	攻击
O O O O O O O O O O O O O B-SUB I-SUB I-SUB I-SUB I-SUB O O [##WordPiece] O [##WordPiece] O O O O O B-OBJ I-OBJ I-OBJ	攻击
O O O O O O O O B-SUB I-SUB I-SUB I-SUB I-SUB I-SUB O O [##WordPiece] O [##WordPiece] [##WordPiece] O O O O O B-OBJ I-OBJ I-OBJ	攻击
B-SUB I-SUB I-SUB I-SUB I-SUB I-SUB O O O B-OBJ I-OBJ I-OBJ O O O O O O O O O O O O O O O O O O O O O O	攻击
B-OBJ I-OBJ I-OBJ O O O O O O B-SUB I-SUB I-SUB O O O O O O O	攻击
O O O B-SUB I-SUB O O O O O O O O O O O O O O O O O O B-OBJ I-OBJ I-OBJ O O O O O O O O O O	攻击
O O O O O B-SUB I-SUB I-SUB O O O O O O O O O O B-OBJ I-OBJ I-OBJ	攻击
O O O O O O O O B-SUB I-SUB O O O O B-OBJ I-OBJ I-OBJ	攻击
B-OBJ I-OBJ I-OBJ I-OBJ I-OBJ I-OBJ I-OBJ O O O O O O O O O O O O O O O O O O O O O B-SUB I-SUB I-SUB O O O O O O O O O O O O O O O O	攻击
O O O O O O B-SUB I-SUB I-SUB O O O O O O O O B-OBJ I-OBJ O O O O O O O O O O O	攻击
O O O O O B-SUB I-SUB O O O O B-OBJ I-OBJ I-OBJ O O O O O O O O O O O O O O	攻击
B-OBJ I-OBJ I-OBJ O O O O O O O O B-SUB I-SUB I-SUB I-SUB O O O	攻击
B-SUB I-SUB I-SUB I-SUB I-SUB I-SUB I-SUB O O O O O O O O O B-OBJ I-OBJ I-OBJ I-OBJ I-OBJ O O O O O O O	攻击
B-SUB I-SUB I-SUB O O O O O O O O O O B-OBJ I-OBJ I-OBJ	攻击
O O O O O O O O O O O O B-SUB I-SUB I-SUB O O O B-OBJ I-OBJ I-OBJ I-OBJ	攻击
B-SUB I-SUB O O O O O O O O O O O O B-OBJ I-OBJ O O O O O O	攻击
B-SUB I-SUB O O O O O O O O O B-OBJ I-OBJ I-OBJ I-OBJ	攻击
O O B-SUB I-SUB O O O O O B-OBJ I-OBJ I-OBJ I-OBJ O O O O O	攻击
B-SUB I-SUB O O O O O O O B-OBJ I-OBJ	攻击
B-SUB I-SUB O O O O O O O O O O O O B-OBJ I-OBJ	攻击
O O O O O O O O B-OBJ I-OBJ O O O O O O O O O O O O O O O O O O O O B-SUB I-SUB O O O	攻击
B-SUB I-SUB O O O O O O O O B-OBJ I-OBJ O O O O O O	攻击
B-SUB I-SUB O O O O O O O O O O O O O B-OBJ I-OBJ O O O O O O O O O O O O O O O O O O O O O O O O O O O O O O O O O O O O O O O O	攻击
O O B-OBJ I-OBJ O O O O O O O O B-SUB I-SUB O O O O O O O O O O O O O O O O O O O O O O	攻击
B-OBJ I-OBJ O O B-SUB I-SUB O O O O O O O O O O O O O	攻击
B-OBJ I-OBJ I-OBJ I-OBJ O O O O O O O O O O O O O B-SUB I-SUB O O O O O O O O O O O O	攻击
O O B-OBJ [##WordPiece] [##WordPiece] [##WordPiece] O B-SUB I-SUB O O O O O O O O O O O	攻击
B-SUB I-SUB I-SUB O O B-OBJ [##WordPiece] [##WordPiece] [##WordPiece]	攻击
B-SUB I-SUB O O O O B-OBJ I-OBJ O O O O O O O	攻击
O B-OBJ I-OBJ O O O O O O O B-SUB I-SUB O O O O O O O O O O O O O O O	攻击
B-SUB I-SUB O O O O O O O O O O O O O O B-OBJ I-OBJ O O O O	攻击
O O O O B-SUB I-SUB O O B-OBJ I-OBJ O O O O O O O O	攻击
O B-OBJ I-OBJ O O O O O O O O O O O B-SUB I-SUB O O O O O O O O O O O O O O O O O O O O O O O O O O	攻击
B-SUB I-SUB O O O O O O O O O O B-OBJ I-OBJ O O O	攻击
B-SUB I-SUB O O O O O O O O B-OBJ I-OBJ O O O O O O O	攻击
B-SUB I-SUB O O O O O O O O O O O O O O O B-OBJ I-OBJ O O O O O O O O O O O O O O O	攻击
B-SUB I-SUB O O O O O O O O O O O O O O O O B-OBJ I-OBJ O O O O O O O O O O O O O O	攻击
O O O B-OBJ I-OBJ O O O O O B-SUB I-SUB O O O O O O O	攻击
B-OBJ I-OBJ O O O O O O O O O O O O O O O O O O B-SUB I-SUB I-SUB I-SUB O O O O O O	攻击
O O O O O O O O O B-SUB I-SUB O O O B-OBJ I-OBJ I-OBJ I-OBJ O O O O O O O O	攻击
B-SUB I-SUB O O O O O O O O O O O O B-OBJ I-OBJ O O O O O O O	攻击
B-SUB I-SUB O O O O O O O O O O O O O O O O O O O O O O O B-OBJ I-OBJ O O O	攻击
B-SUB I-SUB O O B-OBJ I-OBJ O O O O O O O	攻击
B-SUB I-SUB O O O O O O O O B-OBJ I-OBJ O O	攻击
O B-SUB I-SUB O O O O O O O O O O O O O B-OBJ I-OBJ O O O O O O O O O O O	攻击
B-SUB I-SUB O O O O O O O O O O O O O O O O B-OBJ I-OBJ O O O O O	攻击
B-SUB I-SUB O O O O O O O O O O O O O O O O O O O B-OBJ I-OBJ O O O O O O O O	攻击
O O O B-SUB I-SUB O O O O O O O O O O O O O O O O O O O O O O O O O O O O O O O O O O B-OBJ I-OBJ O O O O	攻击
B-SUB I-SUB O O O O O O O O O O O O O O O O O O O O O O O O O O O O B-OBJ I-OBJ O	攻击
O O O O B-SUB I-SUB O O O O O O O O O O O O O O O O O B-OBJ I-OBJ O O O O O O O O O O O O	攻击
B-SUB I-SUB O O O O O O O O O O O O O B-OBJ I-OBJ O O O O O O O O	攻击
B-OBJ I-OBJ I-OBJ I-OBJ O O O O O O O O O O O O O O O O O O O O O O O O O O O O B-SUB I-SUB O O O O O O	攻击
B-OBJ I-OBJ I-OBJ I-OBJ O O O O O O O O O O O O O O O O O O O O B-SUB I-SUB O O O O	攻击
B-SUB I-SUB O O O O O O O O O O O O O B-OBJ I-OBJ O O O O O O O O O O O O O O	攻击
B-SUB I-SUB I-SUB O O O O O O O B-OBJ I-OBJ O O O O O O O O O	攻击
O O O O B-SUB I-SUB O B-OBJ [##WordPiece] [##WordPiece] [##WordPiece] O O O	攻击
O O O B-OBJ I-OBJ I-OBJ O O O O O O B-SUB I-SUB I-SUB O O O O	攻击
B-SUB I-SUB I-SUB I-SUB I-SUB O O O O O O O O O O O O O O O O O O O O O O O O O O O O O O O O O O O O O O O O O O O O O O B-OBJ I-OBJ	攻击
B-SUB I-SUB I-SUB I-SUB I-SUB O O O O B-OBJ [##WordPiece] O O [##WordPiece] [##WordPiece] [##WordPiece] O O O O O O O O O O O O	攻击
B-SUB I-SUB I-SUB I-SUB I-SUB O O O O O [##WordPiece] O B-OBJ [##WordPiece] [##WordPiece] [##WordPiece] O O O O O O O O O O O O	攻击
O O O O B-SUB I-SUB I-SUB O O O O B-OBJ I-OBJ O O O O O O O O O O O O	攻击
O O O O O O O O O O O O O B-SUB I-SUB I-SUB I-SUB I-SUB O B-OBJ I-OBJ I-OBJ I-OBJ I-OBJ I-OBJ O O O O O O O O O O O O O O	管理
B-SUB I-SUB I-SUB O O O O O O O O O O O O O O O O O O O O O O O O O B-OBJ I-OBJ I-OBJ I-OBJ I-OBJ I-OBJ I-OBJ	合作
O O O O O B-SUB I-SUB I-SUB O O B-OBJ I-OBJ I-OBJ O O O O O O O O	合作
B-OBJ I-OBJ I-OBJ O O O O O O B-SUB I-SUB I-SUB O O O O O O O O O O O O	合作
O O O O O O O O B-OBJ I-OBJ O O O O O O O O O B-SUB I-SUB I-SUB O O O [##WordPiece] [##WordPiece] O O O	合作
O O O O O B-SUB I-SUB I-SUB O O O O O O O O B-OBJ I-OBJ I-OBJ	合作
B-SUB I-SUB O B-OBJ I-OBJ O O O O O O O O O O O O	合作
O O O O O O O O B-SUB I-SUB I-SUB I-SUB I-SUB O O O O O O O O O O O O O O O O B-OBJ I-OBJ O O	合作
O O O O O O O O O O O O O O B-SUB I-SUB I-SUB I-SUB O O O O O O O O O O O B-OBJ I-OBJ O O	合作
O B-SUB I-SUB O B-OBJ I-OBJ O O O O O O O O O O O O O O O O	合作
O O O O O O O O O O O O O O O O O B-OBJ I-OBJ I-OBJ O B-SUB I-SUB O O O O O O O O O O O O O O O O O O O O O O O O O O O O O	合作
O O O O O B-OBJ I-OBJ O O O B-SUB I-SUB O O O O O O O O O O O O O O O O O O O O	合作
O O O O O O O O O O O O O O O B-SUB I-SUB O B-OBJ I-OBJ I-OBJ O O O O O O	合作
O O O B-SUB I-SUB O O O O O B-OBJ I-OBJ O O O O	合作
B-SUB I-SUB O O O O O O O O O O O O B-OBJ I-OBJ I-OBJ I-OBJ O O O O O O O O O [##WordPiece] [##WordPiece] [##WordPiece] O O O O O O O	合作
B-SUB I-SUB O O O B-OBJ [##WordPiece] [##WordPiece] [##WordPiece] O O O O O O	合作
B-SUB I-SUB O O O O O O O O O O O O O B-OBJ [##WordPiece] [##WordPiece] [##WordPiece] O O O O O	合作
B-OBJ I-OBJ O B-SUB I-SUB O O O O O O O O O O O O O O O O O O O O O O	合作
O O O O O O O B-OBJ I-OBJ O O O O O B-SUB I-SUB O O O O O	合作
O O O O O B-SUB [##WordPiece] [##WordPiece] [##WordPiece] [##WordPiece] O O O O O O O O O O O O O O O O B-OBJ I-OBJ O O O O O O O O O O O O O O O O O O	合作
B-OBJ I-OBJ O B-SUB I-SUB O O O O O O O O O O O O O O O O O O O O O O O O O O O	合作
B-SUB I-SUB O O O O O O O O O O B-OBJ I-OBJ O O O O O	合作
B-OBJ I-OBJ O O O O O O B-SUB I-SUB I-SUB O O O O O O O O O O O O O O	合作
B-OBJ I-OBJ O O O O O O O O B-SUB I-SUB O O O O O O O O O O O O	合作
B-SUB I-SUB O O O O B-OBJ I-OBJ O O O O O O O O O O O O O O O O O O O O O	合作
B-SUB I-SUB O O O O O B-OBJ I-OBJ	合作
B-SUB I-SUB O O O O O O O O O O O O O O O B-OBJ I-OBJ I-OBJ O O O O O O O O O O O O O O O O	合作
B-SUB I-SUB O O B-OBJ I-OBJ I-OBJ O O O O O O O O O	合作
B-SUB [##WordPiece] [##WordPiece] [##WordPiece] [##WordPiece] O O O O O O O O O O O O O O O O O O O B-OBJ I-OBJ O O O	合作
B-SUB I-SUB O O O O O O O O O O O O O O O B-OBJ I-OBJ I-OBJ O O O O O O O O O O O O O O	合作
B-SUB I-SUB O B-OBJ I-OBJ I-OBJ O O O O O O O O O O O O O O O O O O O O O O O O O O O O O O	合作
B-SUB I-SUB O O O O O B-OBJ I-OBJ I-OBJ O O O O	合作
B-OBJ I-OBJ I-OBJ O O O O O O O O O B-SUB I-SUB O O O O O O O O O O O O O O O O	合作
O O B-SUB I-SUB O O O O O B-OBJ I-OBJ I-OBJ O O O O O O O O O	合作
B-SUB I-SUB O O O O O O O O O B-OBJ I-OBJ I-OBJ O O O O O O O O O O O O O O O O O O O O O O	合作
B-OBJ I-OBJ I-OBJ O O O O O O O B-SUB I-SUB O O O O O O O O O O O O	合作
B-OBJ I-OBJ I-OBJ I-OBJ I-OBJ O O O O B-SUB I-SUB I-SUB I-SUB I-SUB I-SUB I-SUB I-SUB I-SUB O O O O O O O O O O O O O O O O O O O O O O O O O O O O O O	合作
O O O O O O O O O O O O B-SUB I-SUB O O B-OBJ I-OBJ I-OBJ I-OBJ I-OBJ O	合作
O O O O O O B-SUB I-SUB I-SUB O O O O O O B-OBJ I-OBJ I-OBJ O O O O O	合作
B-SUB I-SUB I-SUB O O B-OBJ I-OBJ I-OBJ O O O O	合作
O B-SUB I-SUB O B-OBJ I-OBJ O O O O O O O O	合作
B-SUB I-SUB I-SUB I-SUB I-SUB I-SUB I-SUB O O O O B-OBJ I-OBJ I-OBJ I-OBJ I-OBJ I-OBJ I-OBJ [##WordPiece] [##WordPiece] O O O O O O O O O O O O	合作
O O B-SUB I-SUB I-SUB O O O O O O B-OBJ I-OBJ I-OBJ I-OBJ O O O O O O O O O	合作
O O O B-OBJ I-OBJ I-OBJ I-OBJ O O O O O O O O O O B-SUB I-SUB O O O O O O O	合作
B-SUB I-SUB O B-OBJ I-OBJ I-OBJ I-OBJ I-OBJ I-OBJ I-OBJ I-OBJ O O O O O O	合作
O O O O O B-OBJ I-OBJ I-OBJ O O O B-SUB I-SUB I-SUB I-SUB I-SUB I-SUB I-SUB [##WordPiece] [##WordPiece] O O	合作
B-SUB I-SUB I-SUB I-SUB I-SUB I-SUB O O O O O O O O O O O O O B-OBJ I-OBJ O O O O O	检查
B-SUB I-SUB I-SUB I-SUB I-SUB I-SUB I-SUB I-SUB I-SUB I-SUB O O O O O O O O O O B-OBJ I-OBJ I-OBJ O O O O O O O O	检查
O O O O B-SUB I-SUB I-SUB O O O O O B-OBJ I-OBJ O O O O O O O O O O O O	竞争
O O B-SUB I-SUB I-SUB O O O O O O O O O O O O O O O O O O O B-OBJ I-OBJ I-OBJ	竞争
B-SUB I-SUB B-OBJ I-OBJ O O O O O O O O O O O O O O O O O O	竞争
B-SUB I-SUB I-SUB O O O B-OBJ I-OBJ O O O O O O O O O O O O	竞争
B-SUB I-SUB O O O O O O O O B-OBJ I-OBJ I-OBJ	竞争
O O B-OBJ I-OBJ O O B-SUB I-SUB I-SUB I-SUB I-SUB I-SUB O O O O O O O O O O O O O	隶属
O O O O O B-OBJ I-OBJ O O B-SUB [##WordPiece] I-SUB I-SUB I-SUB I-SUB I-SUB O O O O O O O O O	隶属
B-OBJ I-OBJ B-SUB I-SUB I-SUB I-SUB I-SUB O O O O O O O O O	隶属
O B-OBJ I-OBJ O O O O O O O O [##WordPiece] [##WordPiece] [##WordPiece] O B-SUB [##WordPiece] [##WordPiece] I-SUB I-SUB I-SUB O O O O O O O O	隶属
B-OBJ I-OBJ O O O O B-SUB I-SUB I-SUB [##WordPiece] I-SUB I-SUB I-SUB I-SUB I-SUB O O O O O O [##WordPiece] O O O O O	隶属
B-OBJ I-OBJ O O O O O O O [##WordPiece] O O O O O O O O B-SUB I-SUB I-SUB [##WordPiece] I-SUB I-SUB I-SUB I-SUB I-SUB	隶属
B-OBJ I-OBJ O O O O O O O O O B-SUB I-SUB I-SUB I-SUB I-SUB I-SUB I-SUB I-SUB I-SUB I-SUB I-SUB I-SUB I-SUB I-SUB	隶属
O O O O O O O O O O O B-OBJ I-OBJ O O B-SUB I-SUB [##WordPiece] I-SUB I-SUB I-SUB I-SUB I-SUB I-SUB	隶属
O O B-OBJ I-OBJ O O B-SUB I-SUB I-SUB [##WordPiece] I-SUB I-SUB I-SUB I-SUB I-SUB O O O O O O O O O O O O O O O O O O	隶属
O O B-OBJ I-OBJ O O O O O O O O O O O O O O O B-SUB I-SUB I-SUB I-SUB I-SUB	隶属
B-OBJ I-OBJ O O O B-SUB I-SUB I-SUB [##WordPiece] I-SUB I-SUB I-SUB I-SUB I-SUB I-SUB O O O O O O O O O O O O O	隶属
B-OBJ I-OBJ O O O B-SUB I-SUB I-SUB [##WordPiece] I-SUB I-SUB I-SUB I-SUB I-SUB O O O O O O O O O O O O	隶属
B-OBJ I-OBJ O O O O O B-SUB I-SUB I-SUB [##WordPiece] I-SUB I-SUB I-SUB I-SUB I-SUB I-SUB I-SUB	隶属
O O O O O B-OBJ I-OBJ O O O O B-SUB I-SUB I-SUB I-SUB I-SUB I-SUB O O O O O O O O O O O O O O O O O O	隶属
B-OBJ I-OBJ O B-SUB I-SUB I-SUB O O O O O O O O O O O O O O	隶属
B-OBJ I-OBJ I-SUB I-SUB I-SUB I-SUB I-SUB O O O O O O O O O O O O O O O O O O O O O O O O O O O O	隶属
O O O O O O O O O O O O O O O O O O O B-OBJ I-OBJ I-SUB I-SUB I-SUB O O O O O O O	隶属
B-OBJ I-OBJ B-SUB I-SUB I-SUB O O O O O O O O O O O O O O O O O O O O O O	隶属
B-SUB I-SUB I-SUB O O O O O O O B-OBJ I-OBJ O O O O O O O O	隶属
O O O O O O O B-SUB I-SUB I-SUB O O O O O O B-OBJ I-OBJ O O O O O O O O O O O O O O O O O O O O O O O O O	隶属
O B-OBJ I-OBJ O O O O O O O O O B-SUB I-SUB I-SUB O O O O O O O O O O	隶属
B-OBJ I-OBJ O O B-SUB I-SUB I-SUB I-SUB I-SUB I-SUB I-SUB O O O O O O O O O	隶属
B-OBJ I-OBJ O O O O O B-SUB I-SUB I-SUB I-SUB I-SUB I-SUB O O O O O O O O O O O O O O O O O O O	隶属
B-OBJ I-OBJ I-OBJ O O O O O O O O O O O O O O O O O O O B-SUB I-SUB I-SUB I-SUB I-SUB I-SUB I-SUB I-SUB I-SUB I-SUB O	隶属
B-SUB I-SUB I-SUB I-SUB I-SUB I-SUB I-SUB I-SUB I-SUB I-SUB O O O O O B-OBJ I-OBJ O O O O O O O O O O O O O O	隶属
O O O O O O O B-OBJ I-OBJ B-SUB I-SUB I-SUB [##WordPiece] I-SUB I-SUB I-SUB I-SUB I-SUB O O O O O O O O O O O O O O O	隶属
B-OBJ I-OBJ I-OBJ I-OBJ O O O O O O O O B-SUB I-SUB I-SUB I-SUB I-SUB I-SUB O O O O O O O	隶属
O O O B-OBJ I-OBJ I-OBJ I-OBJ I-OBJ I-OBJ I-OBJ O O O O O O O O O O O O O O O O B-SUB I-SUB I-SUB I-SUB I-SUB O O O O O O O O	隶属
O B-OBJ I-OBJ O O O O O O O O O O O O O B-SUB I-SUB I-SUB I-SUB I-SUB I-SUB I-SUB O O O O O O O O O O O O O O O O O O O O O O O O O O O O O O O O O O O O O O O O O O O O O O O O O O O O O O O O O O O O O O O O O	隶属
O B-OBJ I-OBJ O O B-SUB I-SUB I-SUB I-SUB I-SUB I-SUB I-SUB O O O O O O O O O O O O O O O O O	隶属
B-OBJ I-OBJ I-OBJ I-OBJ O O O O O O O O O O O O O O O O O O O O O O O O O O O O O O O B-SUB I-SUB I-SUB I-SUB I-SUB I-SUB O O O O O O O O	隶属
B-OBJ I-OBJ I-OBJ I-OBJ O O O O O O O O O O O O O O O O O O O O O O O O O O O O O O O O O O O O O O B-SUB I-SUB I-SUB I-SUB I-SUB I-SUB O	隶属
O B-SUB I-SUB I-SUB I-SUB I-SUB I-SUB I-SUB I-SUB I-SUB I-SUB I-SUB O B-OBJ I-OBJ I-OBJ I-OBJ I-OBJ I-OBJ O O O O O O O O O O O O O O O O	隶属
B-OBJ I-OBJ I-OBJ I-OBJ I-OBJ I-OBJ I-OBJ I-OBJ O B-SUB I-SUB I-SUB I-SUB I-SUB I-SUB I-SUB I-SUB I-SUB I-SUB O O O O O O O O O O O O O O O	隶属
B-OBJ I-OBJ I-OBJ I-OBJ I-OBJ I-OBJ I-OBJ O O O O O O O O O O O O O O B-SUB I-SUB I-SUB I-SUB I-SUB O O O O	隶属
O O O O O O O O O O O O O B-OBJ I-OBJ I-OBJ I-OBJ I-OBJ I-OBJ I-OBJ O B-SUB I-SUB I-SUB I-SUB I-SUB I-SUB I-SUB O O O O O O O O O O O O O O O O O O O O O O O O O O O O O O O O O O O O O O	隶属
O B-OBJ I-OBJ I-OBJ I-OBJ I-OBJ I-OBJ I-OBJ O O O O B-SUB I-SUB I-SUB I-SUB I-SUB I-SUB O O O O O O O O O O O O O O O O O O O O O O O O O O O O O O	隶属
O B-OBJ I-OBJ I-OBJ I-OBJ I-OBJ I-OBJ I-OBJ O O O O O O O O O O O B-SUB I-SUB I-SUB I-SUB I-SUB I-SUB I-SUB I-SUB I-SUB I-SUB O O O O O O O O O O O O O O O O O O O	隶属
O O O O B-OBJ I-OBJ I-OBJ I-OBJ O O O O O O O B-SUB I-SUB I-SUB O O O O O O O O O O O	隶属
B-OBJ I-OBJ O O B-SUB I-SUB I-SUB I-SUB I-SUB I-SUB O O O O O O O O O O O O O O O O O O O O O O O O O O O O O O O O O O O O O O O O	隶属
B-OBJ I-OBJ I-OBJ I-OBJ I-OBJ I-OBJ I-OBJ O O O O O O O O O O O B-SUB I-SUB I-SUB I-SUB I-SUB I-SUB I-SUB O O [##WordPiece] O O O O O O O	隶属
O O O O B-OBJ I-OBJ I-OBJ I-OBJ I-OBJ O O O O O O O O O O O O O O O O O O O O O O B-SUB I-SUB I-SUB I-SUB I-SUB I-SUB I-SUB I-SUB I-SUB O O O O O O O O O O O O	隶属
B-SUB I-SUB I-SUB I-SUB I-SUB O O O O O O O O O O O O O O O O O O B-OBJ [##WordPiece] I-OBJ I-OBJ O O O O O O O O O O O O O O O O O O O O O O O	隶属
O O O O O O O O O O O O O O O O B-OBJ I-OBJ I-OBJ I-OBJ I-OBJ O O O B-SUB I-SUB I-SUB I-SUB I-SUB I-SUB O O O O O O O O O O O O	隶属
O O O O B-OBJ [##WordPiece] O O B-SUB I-SUB I-SUB I-SUB I-SUB O O O O O O O O O O O O O O O O O O O O O O O	隶属
O O O O B-OBJ [##WordPiece] O O O B-SUB I-SUB I-SUB I-SUB I-SUB O O O O O O O O O O O O O O O O O O O O O O O O O O O	隶属
O O B-OBJ I-OBJ I-OBJ O O O B-SUB I-SUB I-SUB I-SUB I-SUB I-SUB O O O O O O O O O O O O O O O O O O O O	隶属
O O O O O O O O O O O O O O O O B-OBJ I-OBJ I-OBJ O O O B-SUB I-SUB I-SUB I-SUB I-SUB I-SUB O O O O O O	隶属
B-OBJ I-OBJ O B-SUB I-SUB I-SUB I-SUB O O O O O O O O O O O O O O O O O O O O O O O O	隶属
B-OBJ I-OBJ O O O O O B-SUB I-SUB I-SUB I-SUB I-SUB I-SUB O O O O O O O O O O O O O O O O O O	隶属
B-OBJ I-OBJ O O O O O O O O O O O O B-SUB I-SUB I-SUB I-SUB I-SUB I-SUB O O O O O O O O O O O	隶属
B-OBJ I-OBJ O O O O B-SUB I-SUB I-SUB O O O O O O O O	隶属
B-OBJ I-OBJ O O B-SUB I-SUB I-SUB I-SUB I-SUB O O O O O O O O O O	隶属
B-OBJ I-OBJ O O O O O O O O B-SUB I-SUB I-SUB I-SUB O O O O O	隶属
O O B-OBJ I-OBJ I-OBJ O O O B-SUB I-SUB I-SUB I-SUB I-SUB I-SUB I-SUB O O O O O O O O O O O O O O	隶属
O O B-OBJ I-OBJ I-OBJ O O O O O O O O O O O B-SUB I-SUB I-SUB I-SUB I-SUB O O O O O O O O	隶属
B-OBJ I-OBJ O O O O O O O O O O O O O O O O O O O O O O B-SUB I-SUB I-SUB O O O O O O O O O O O O O O O O O O O	隶属
O B-OBJ I-OBJ I-OBJ I-OBJ I-SUB I-SUB I-SUB I-SUB I-SUB I-SUB I-SUB O O O O O O	隶属
B-OBJ I-OBJ I-OBJ O O O O O O O O O O O O O O O O O O O B-SUB I-SUB I-SUB I-SUB I-SUB I-SUB I-SUB I-SUB I-SUB I-SUB	隶属
O O O O O O O O O O O O B-SUB I-SUB I-SUB B-OBJ I-OBJ I-OBJ I-SUB I-SUB I-SUB I-SUB I-SUB I-SUB	隶属
B-OBJ I-OBJ O O O O O O O O O O O O O O O O O B-SUB I-SUB O O O O O O O O O	隶属
O O O O O B-OBJ I-OBJ O O B-SUB I-SUB I-SUB I-SUB I-SUB O O O O O O O O O O O O O O	隶属
B-OBJ I-OBJ I-OBJ I-OBJ I-OBJ O O O O O O O O O O O O O O B-SUB I-SUB I-SUB O O O O O O O O	隶属
B-OBJ I-OBJ O O O O O O O O O O O O O B-SUB I-SUB O O O O O O O O O O O	隶属
B-OBJ I-OBJ O O O O O O O O O O O O B-SUB I-SUB	隶属
B-OBJ I-OBJ O O O O O O O O B-SUB I-SUB I-SUB I-SUB I-SUB I-SUB I-SUB I-SUB O O O O O O O O O O O O O O O O O	隶属
B-OBJ I-OBJ O O O O O O O O O O O O O B-SUB I-SUB I-SUB I-SUB I-SUB I-SUB O O	隶属
B-OBJ I-OBJ O O O O O O O O O O O O O O O O O O O O O B-SUB I-SUB I-SUB O O O O O O O O O O O O	隶属
B-OBJ I-OBJ I-OBJ I-OBJ I-OBJ I-OBJ B-SUB I-SUB I-SUB I-SUB I-SUB I-SUB O O O O O O O O O O O O O	隶属
B-OBJ I-OBJ I-OBJ I-OBJ I-OBJ I-OBJ O O O O O O O B-SUB I-SUB I-SUB I-SUB I-SUB O O O O O O O	隶属
B-OBJ I-OBJ O O B-SUB I-SUB I-SUB [##WordPiece] I-SUB I-SUB I-SUB I-SUB I-SUB O O [##WordPiece] O O [##WordPiece] O O O O O	隶属
B-OBJ I-OBJ O O O O O [##WordPiece] O O O O O O B-SUB [##WordPiece] I-SUB I-SUB [##WordPiece] I-SUB I-SUB I-SUB I-SUB I-SUB	隶属
B-OBJ I-OBJ O O O O O O O B-SUB I-SUB I-SUB I-SUB I-SUB	隶属
O O B-OBJ I-OBJ O O B-SUB I-SUB I-SUB I-SUB I-SUB I-SUB	隶属
B-OBJ I-OBJ O B-SUB I-SUB I-SUB I-SUB I-SUB I-SUB O O O O O O O O O O O O O O	隶属
O O O O B-OBJ I-OBJ O O O B-SUB I-SUB I-SUB I-SUB I-SUB [##WordPiece] I-SUB I-SUB I-SUB I-SUB	隶属
O O O B-OBJ I-OBJ I-OBJ I-OBJ B-SUB I-SUB O O O O O O O O O O O O O O O O O O O O O O O O O O O O	隶属
O O B-OBJ I-OBJ I-OBJ B-SUB [##WordPiece] I-SUB I-SUB I-SUB I-SUB I-SUB I-SUB I-SUB I-SUB I-SUB I-SUB I-SUB O O O O O O O O O O O O O O O O O O O	隶属
O O O O O O O O B-OBJ I-OBJ I-OBJ I-OBJ I-OBJ I-OBJ O B-SUB I-SUB I-SUB I-SUB I-SUB [##WordPiece] I-SUB I-SUB I-SUB I-SUB	隶属
B-OBJ I-OBJ I-OBJ I-OBJ I-OBJ B-SUB [##WordPiece] I-SUB I-SUB I-SUB I-SUB I-SUB O O O O O O	隶属
B-OBJ I-OBJ O O O O O O O O O O O O O O B-SUB I-SUB I-SUB I-SUB I-SUB O	隶属
B-OBJ I-OBJ I-OBJ I-OBJ I-OBJ B-SUB I-SUB I-SUB O O O O O O O O O O O O O	隶属
B-OBJ I-OBJ I-OBJ I-OBJ I-OBJ O O O O B-SUB I-SUB I-SUB O O O O O O O O O	隶属
B-OBJ I-OBJ O O O O O O O O O O O B-SUB I-SUB I-SUB I-SUB I-SUB I-SUB I-SUB I-SUB I-SUB I-SUB I-SUB O	隶属
B-OBJ I-OBJ O O O O O O B-SUB I-SUB I-SUB I-SUB I-SUB I-SUB I-SUB I-SUB O O O O O O O O O O O O O O	隶属
B-OBJ I-OBJ B-SUB I-SUB I-SUB I-SUB I-SUB I-SUB I-SUB O O O O O O O O O O O O O O	隶属
B-OBJ I-OBJ O O O O O O O O O B-SUB I-SUB I-SUB I-SUB I-SUB I-SUB I-SUB I-SUB I-SUB O O O O O O O O O O	隶属
O O O O O B-SUB I-SUB I-SUB I-SUB I-SUB I-SUB I-SUB I-SUB O O O O B-OBJ I-OBJ I-OBJ I-OBJ I-OBJ I-OBJ I-OBJ I-OBJ I-OBJ O O O O	隶属
O O O O O O O O O O O B-OBJ I-OBJ B-SUB I-SUB I-SUB [##WordPiece] I-SUB I-SUB I-SUB O	隶属
B-OBJ I-OBJ B-SUB I-SUB I-SUB [##WordPiece] I-SUB I-SUB I-SUB I-SUB I-SUB O O O O O O O O O O O O O O O O O O O O O O O O O O O O O O O O O O O O O O O	隶属
B-OBJ I-OBJ O O O [##WordPiece] O O O O O O B-SUB I-SUB I-SUB I-SUB I-SUB I-SUB O O O O O O O O O O O O O O O O O O O O O O O O O O O O O O O O	隶属
O O B-OBJ I-OBJ B-SUB I-SUB I-SUB [##WordPiece] O O O O O O O O O O O O O O O	隶属
B-OBJ I-OBJ I-SUB I-SUB I-SUB [##WordPiece] I-SUB I-SUB I-SUB I-SUB I-SUB O O O O O O O O O O O O O O O O O O O O O O O O O O O O O O	隶属
B-OBJ I-OBJ O O B-SUB I-SUB I-SUB I-SUB I-SUB I-SUB O O O O O O O	隶属
B-OBJ I-OBJ O O B-SUB I-SUB I-SUB [##WordPiece] O O O O O O O O O O O O O O	隶属
B-OBJ I-OBJ B-SUB I-SUB I-SUB [##WordPiece] I-SUB I-SUB I-SUB I-SUB I-SUB I-SUB I-SUB I-SUB I-SUB I-SUB O O O O O O O O O O O O O O	隶属
O O O O O O B-OBJ I-OBJ I-OBJ B-SUB I-SUB I-SUB I-SUB I-SUB O O O O O O O O O O	隶属
O O O O O O O O B-OBJ I-OBJ B-SUB I-SUB I-SUB O O O O O O O O O O O O O O O O O O O	隶属
O O O O O B-OBJ I-OBJ I-OBJ I-OBJ O O B-SUB I-SUB I-SUB I-SUB I-SUB I-SUB I-SUB I-SUB O O O O O O O	隶属
B-OBJ I-OBJ I-OBJ O O O O O O O O B-SUB I-SUB I-SUB I-SUB I-SUB I-SUB I-SUB I-SUB I-SUB I-SUB I-SUB I-SUB I-SUB	隶属
B-OBJ I-OBJ O O O O O O B-SUB I-SUB I-SUB I-SUB I-SUB O O O O O O O O O O O O O O O O O O O O	隶属
O O O O O O B-OBJ I-OBJ O O O O B-SUB [##WordPiece] [##WordPiece] I-SUB I-SUB I-SUB I-SUB I-SUB	隶属
B-OBJ I-OBJ O O B-SUB I-SUB I-SUB O O O O	任职
O O B-OBJ I-OBJ I-OBJ O O B-SUB I-SUB I-SUB	任职
B-OBJ I-OBJ I-OBJ O O O O O B-SUB I-SUB O O O O O O O	任职
O O O O O O B-OBJ I-OBJ I-OBJ O O O B-SUB I-SUB O O O O O	任职
O O O B-OBJ I-OBJ I-OBJ O O B-SUB I-SUB I-SUB I-SUB O O O O O O O O O	任职
B-OBJ I-OBJ I-OBJ O O O O O B-SUB I-SUB I-SUB O O O O O	任职
O O O B-OBJ I-OBJ I-OBJ O O O B-SUB I-SUB I-SUB O O O O O O O O	任职
B-OBJ I-OBJ O O O B-SUB I-SUB I-SUB I-SUB O O O O O O O O O	任职
B-OBJ I-OBJ O O O B-SUB I-SUB I-SUB O O	任职
O O O O O O O O O O O O O O O B-OBJ I-OBJ I-OBJ I-OBJ I-OBJ O O O B-SUB I-SUB	任职
B-OBJ I-OBJ O O O O O O O B-SUB I-SUB	任职
B-OBJ I-OBJ O O O O O O O B-SUB I-SUB O O O O O O O O	任职
B-OBJ I-OBJ O O O O O O B-SUB I-SUB I-SUB I-SUB	任职
O O O O O O O O O O O O O O O O O B-OBJ I-OBJ I-OBJ O B-SUB I-SUB I-SUB I-SUB I-SUB I-SUB I-SUB	任职
O O O O O O O O O O O O O O O O O O O O O O O B-OBJ I-OBJ I-OBJ O O B-SUB I-SUB I-SUB I-SUB I-SUB I-SUB I-SUB	任职
B-OBJ I-OBJ I-OBJ O O O O O O O O O O B-SUB I-SUB I-SUB I-SUB I-SUB O O [##WordPiece] O [##WordPiece] O O O O O O O O	任职
O O O B-OBJ I-OBJ I-OBJ O O B-SUB I-SUB I-SUB I-SUB I-SUB I-SUB O O [##WordPiece] O [##WordPiece] [##WordPiece] O O O O O O O O	任职
B-OBJ I-OBJ I-OBJ I-OBJ I-OBJ O O O O O B-SUB I-SUB I-SUB I-SUB I-SUB I-SUB I-SUB	任职
B-OBJ I-OBJ O O O O O O O B-SUB I-SUB I-SUB I-SUB	任职
B-OBJ I-OBJ I-OBJ I-OBJ I-OBJ O O O B-SUB I-SUB O O [##WordPiece] [##WordPiece] O [##WordPiece] O O	任职
B-OBJ I-OBJ I-OBJ I-OBJ I-OBJ I-OBJ I-OBJ O O O O O B-SUB I-SUB I-SUB I-SUB I-SUB I-SUB	任职
B-OBJ I-OBJ I-OBJ O O O O O B-SUB I-SUB O O O O O O O O O O O O O O O O O O O O O O O	任职
O O O O O O O O O O O O O B-OBJ I-OBJ I-OBJ O O B-SUB I-SUB I-SUB O O O O O O O O O O O O	任职
B-OBJ I-OBJ I-OBJ I-OBJ I-OBJ I-OBJ O O B-SUB I-SUB I-SUB I-SUB	任职
B-OBJ I-OBJ I-OBJ O O O O O B-SUB I-SUB I-SUB I-SUB O O [##WordPiece] O [##WordPiece] [##WordPiece] [##WordPiece] O O O O O	任职
B-SUB I-SUB I-SUB O B-OBJ I-OBJ I-OBJ I-OBJ I-OBJ I-OBJ I-OBJ I-OBJ I-OBJ O O O O O O	任职
B-OBJ I-OBJ O O O O O O O O B-SUB I-SUB I-SUB O O O O O O O O	任职
B-OBJ I-OBJ I-OBJ I-OBJ I-OBJ I-OBJ O O O O O O O O O B-SUB I-SUB I-SUB I-SUB O O O	任职
B-OBJ I-OBJ I-OBJ O O O O O B-SUB I-SUB O O O O O O O O O O O O O O O [##WordPiece] [##WordPiece] O O O	任职
B-OBJ I-OBJ O O B-SUB I-SUB I-SUB O O O O	任职
O O O O O O O O O O O B-OBJ I-OBJ I-OBJ I-OBJ I-OBJ I-OBJ I-OBJ I-OBJ O O O O B-SUB I-SUB I-SUB O O O O O O O O O O	任职
O O O O O O O O O O O O O O O B-OBJ I-OBJ I-OBJ O O O B-SUB I-SUB I-SUB I-SUB O O O	任职
B-OBJ I-OBJ I-OBJ I-OBJ I-OBJ O O B-SUB I-SUB I-SUB	任职
O O B-OBJ I-OBJ O O B-SUB I-SUB I-SUB O O O O O O O O O O O O O O O O O	任职
O O B-OBJ I-OBJ O O O O B-SUB I-SUB I-SUB O O O O	任职
B-OBJ I-OBJ O O O O B-SUB I-SUB I-SUB	任职
B-OBJ I-OBJ I-OBJ O O B-SUB I-SUB I-SUB	任职
B-OBJ I-OBJ I-OBJ I-OBJ O O O O O O B-SUB I-SUB I-SUB I-SUB I-SUB O O O [##WordPiece] [##WordPiece] [##WordPiece] [##WordPiece] O O O O O	任职
O O B-OBJ I-OBJ I-OBJ O O O B-SUB I-SUB I-SUB O O [##WordPiece] O [##WordPiece] [##WordPiece] O O O O O O O	任职
B-OBJ I-OBJ O O O B-SUB I-SUB O O O O O O O O	任职
O O B-OBJ I-OBJ I-OBJ O O O B-SUB I-SUB I-SUB O O O O O O	任职
O O B-OBJ I-OBJ I-OBJ O O O O O O O O O O O O O O B-SUB I-SUB I-SUB I-SUB O O [##WordPiece] [##WordPiece] O [##WordPiece] [##WordPiece] O O O O O O O	任职
B-OBJ I-OBJ I-OBJ O O O O O B-SUB I-SUB	任职
B-OBJ I-OBJ O O B-SUB I-SUB I-SUB O O O O O O O O	任职
B-OBJ I-OBJ I-OBJ I-OBJ I-OBJ O O O O O O O O O O O O O B-SUB I-SUB I-SUB I-SUB I-SUB O O O O O O O O	任职
B-OBJ I-OBJ I-OBJ I-OBJ I-OBJ O O O O O O B-SUB I-SUB I-SUB I-SUB I-SUB I-SUB I-SUB I-SUB O O O [##WordPiece] [##WordPiece] [##WordPiece] [##WordPiece] O O O O O	任职
O O O O O B-OBJ I-OBJ I-OBJ O O O B-SUB I-SUB I-SUB I-SUB I-SUB I-SUB I-SUB I-SUB O O O [##WordPiece] [##WordPiece] [##WordPiece] [##WordPiece] O O O O O	任职
B-OBJ I-OBJ I-OBJ O O O O O O B-SUB I-SUB I-SUB I-SUB I-SUB I-SUB O O [##WordPiece] O [##WordPiece] [##WordPiece] O O O O O O O O O	任职
O O O B-OBJ I-OBJ I-OBJ O O O B-SUB I-SUB I-SUB I-SUB I-SUB I-SUB O O [##WordPiece] O [##WordPiece] [##WordPiece] O O O O O O O O O	任职
O B-OBJ I-OBJ I-OBJ O B-SUB I-SUB I-SUB I-SUB I-SUB O O O [##WordPiece] O O O O O O O O	任职
O O O O O O O O O O O B-OBJ I-OBJ O O O O O O O O O O O O O O O B-SUB I-SUB I-SUB I-SUB I-SUB I-SUB I-SUB I-SUB I-SUB	任职
O O B-OBJ I-OBJ O O O O B-SUB I-SUB I-SUB I-SUB I-SUB O O O O O	任职
B-OBJ I-OBJ I-OBJ I-OBJ I-OBJ O O B-SUB I-SUB I-SUB O O O [##WordPiece] O O O O O O	任职
B-OBJ I-OBJ O O B-SUB I-SUB I-SUB I-SUB O O [##WordPiece] O [##WordPiece] [##WordPiece] [##WordPiece] [##WordPiece] O O O	任职
B-OBJ I-OBJ I-OBJ O O O O O B-SUB I-SUB O O O O O O O O	任职
B-OBJ I-OBJ I-OBJ I-OBJ I-OBJ I-OBJ I-OBJ O O O O O O O O B-SUB I-SUB O O O O O	任职
B-OBJ I-OBJ O O O B-SUB I-SUB I-SUB O O O O O O O O O	任职
B-OBJ I-OBJ I-OBJ O O O O O O O B-SUB I-SUB [##WordPiece] O O	任职
B-OBJ I-OBJ I-OBJ I-OBJ I-OBJ I-OBJ I-OBJ I-OBJ I-OBJ O O O O O O O O O O O O O O B-SUB I-SUB I-SUB I-SUB I-SUB I-SUB I-SUB	任职
O O B-OBJ I-OBJ I-OBJ O O O O O B-SUB I-SUB I-SUB I-SUB I-SUB O O	任职
O O O O O O O B-OBJ I-OBJ I-OBJ O B-SUB I-SUB I-SUB O O O O O O O O O O O O	任职
O O O O O O B-SUB I-SUB I-SUB O O O O O O B-OBJ I-OBJ O O	任职
B-OBJ I-OBJ I-OBJ I-OBJ I-OBJ I-OBJ I-OBJ I-OBJ I-OBJ I-OBJ O O O O O O O O O O O O B-SUB I-SUB I-SUB I-SUB I-SUB I-SUB O	任职
B-OBJ I-OBJ I-OBJ I-OBJ I-OBJ I-OBJ O O O O O B-SUB I-SUB I-SUB I-SUB I-SUB I-SUB I-SUB I-SUB I-SUB I-SUB O	任职
O O O O O B-OBJ I-OBJ I-OBJ I-OBJ I-OBJ I-OBJ I-OBJ I-OBJ I-OBJ I-OBJ O O B-SUB I-SUB I-SUB I-SUB I-SUB I-SUB O O O O O O O O O O O O O	任职
B-OBJ I-OBJ I-OBJ I-OBJ I-OBJ I-OBJ I-OBJ I-OBJ I-OBJ I-OBJ I-OBJ I-OBJ I-OBJ I-OBJ O O B-SUB I-SUB	任职
B-OBJ I-OBJ I-OBJ I-OBJ I-OBJ I-OBJ I-OBJ I-OBJ I-OBJ I-OBJ I-OBJ I-OBJ I-OBJ I-OBJ O O B-SUB I-SUB I-SUB I-SUB I-SUB I-SUB O O O O O O O O O O O O O O O O O O O O O O O O O O O O O O O O O O O O O O O O O O O	任职
O O O O B-OBJ I-OBJ I-OBJ O O B-SUB I-SUB I-SUB I-SUB I-SUB	任职
O O B-OBJ I-OBJ I-OBJ I-OBJ I-OBJ O O B-SUB I-SUB I-SUB I-SUB I-SUB I-SUB I-SUB I-SUB O O O O O O O O O O O O O	任职
O O B-OBJ I-OBJ I-OBJ I-OBJ I-OBJ I-OBJ O O B-SUB I-SUB I-SUB I-SUB I-SUB I-SUB O O O O O O O	任职
O O B-OBJ I-OBJ I-OBJ I-OBJ O O B-SUB I-SUB I-SUB I-SUB I-SUB O O O O O O O O O O O O O O	任职
B-OBJ I-OBJ I-OBJ I-OBJ I-OBJ I-OBJ I-OBJ I-OBJ I-OBJ I-OBJ I-OBJ I-OBJ I-OBJ I-OBJ O O B-SUB I-SUB I-SUB I-SUB I-SUB O	任职
B-OBJ I-OBJ I-OBJ I-OBJ I-OBJ O O B-SUB I-SUB I-SUB I-SUB I-SUB O O O O O O O O O O O O O O O O	任职
B-OBJ I-OBJ I-OBJ I-OBJ I-OBJ I-OBJ I-OBJ I-OBJ I-OBJ I-OBJ I-OBJ O O O O O B-SUB I-SUB I-SUB I-SUB I-SUB I-SUB O O O O O O O O O O	任职
B-OBJ I-OBJ I-OBJ I-OBJ I-OBJ I-OBJ I-OBJ I-OBJ I-OBJ I-OBJ I-OBJ I-OBJ I-OBJ I-OBJ O O O O B-SUB I-SUB I-SUB I-SUB I-SUB I-SUB O O	任职
O O O O O O O O O O O O B-OBJ I-OBJ O O B-SUB I-SUB I-SUB O O O O O O	任职
B-OBJ I-OBJ I-OBJ I-OBJ I-OBJ I-OBJ I-OBJ I-OBJ I-OBJ I-OBJ O O B-SUB I-SUB I-SUB I-SUB I-SUB I-SUB I-SUB I-SUB I-SUB I-SUB [##WordPiece] [##WordPiece] I-SUB O O O O	任职
B-OBJ I-OBJ I-OBJ I-OBJ I-OBJ I-OBJ I-OBJ I-OBJ I-OBJ I-OBJ O B-SUB I-SUB I-SUB I-SUB I-SUB I-SUB I-SUB I-SUB I-SUB I-SUB [##WordPiece] I-SUB O O O O O O O	任职
B-OBJ I-OBJ O O B-SUB I-SUB I-SUB O O O O O O O O O O O O O O O O O O O O O O	任职
B-OBJ I-OBJ I-OBJ I-OBJ I-OBJ O O B-SUB I-SUB I-SUB	任职
B-OBJ I-OBJ I-OBJ O O B-SUB I-SUB I-SUB O O O O O O O O O O O O O O O O O O O O O O O O O O O O	任职
O O O O O O O O O B-OBJ I-OBJ I-OBJ O B-SUB I-SUB I-SUB O O O O O O O O O O O O O O O O O O O O	任职
O O O B-OBJ I-OBJ I-OBJ I-OBJ I-OBJ O O B-SUB I-SUB I-SUB O O	任职
B-OBJ O O O B-SUB I-SUB I-SUB I-SUB O O O O O O O O O O O O O	任职
O O O O O O O O O O O O O O O O O O O B-OBJ I-OBJ I-OBJ I-OBJ I-OBJ I-OBJ I-OBJ I-OBJ I-OBJ I-OBJ I-OBJ I-OBJ I-OBJ I-OBJ I-OBJ O O O O O O O O B-SUB I-SUB I-SUB I-SUB I-SUB I-SUB I-SUB O O O O	任职
B-SUB I-SUB I-SUB O O O O O O O O O O O O O O O O O O O O O O O O B-OBJ I-OBJ O O O O O	任职
B-OBJ I-OBJ O O O B-SUB I-SUB I-SUB O O O O O O O O O O O O	任职
B-OBJ I-OBJ O O B-SUB I-SUB I-SUB O O O O O O O O O O O O O O O O O O O	任职
B-OBJ I-OBJ O O O B-SUB I-SUB I-SUB O O O O	任职
O O O O O O O O O O O O O O O O O O B-OBJ I-OBJ O O B-SUB I-SUB I-SUB O O	任职
B-OBJ I-OBJ I-OBJ I-OBJ I-OBJ I-OBJ I-OBJ O O [##WordPiece] O O O O O O O O O O O O O O O [##WordPiece] O O O O O O O O O O O O O O B-SUB I-SUB I-SUB I-SUB I-SUB I-SUB I-SUB I-SUB I-SUB I-SUB O O O O O O O O O O O	任职
O O B-OBJ I-OBJ I-OBJ O O B-SUB I-SUB I-SUB I-SUB I-SUB I-SUB I-SUB I-SUB I-SUB I-SUB [##WordPiece] [##WordPiece] O O O O O O O O O O O O O O O O O [##WordPiece] O O O O O O O O O	任职
B-SUB I-SUB I-SUB O O O O O O O O O O O O O O O O O B-OBJ I-OBJ O O O O	任职
O O O B-OBJ I-OBJ I-OBJ O O B-SUB I-SUB I-SUB I-SUB I-SUB I-SUB I-SUB	任职
B-OBJ I-OBJ I-OBJ I-OBJ I-OBJ O O B-SUB I-SUB I-SUB I-SUB I-SUB I-SUB I-SUB O O O O O O O O O O O	任职
O O O B-OBJ I-OBJ I-OBJ O O O O B-SUB I-SUB I-SUB I-SUB I-SUB O O O O O O O O O O O O O O O O O O O O O	任职
B-OBJ I-OBJ I-OBJ O O O O O B-SUB I-SUB O O O O O O O O O O O O O O O O O O O O O O O O O	任职
O O O O O O O O O O O O O O O O O O O B-OBJ I-OBJ I-OBJ I-OBJ I-OBJ I-OBJ I-OBJ O O O O O O O O O O O O O O O O O B-SUB I-SUB I-SUB I-SUB I-SUB I-SUB O O O O O O O O O O O O O O O O O O O O O O O	任职
B-OBJ I-OBJ I-OBJ I-OBJ I-OBJ I-OBJ I-OBJ I-OBJ I-OBJ O O O B-SUB I-SUB I-SUB I-SUB I-SUB I-SUB I-SUB I-SUB I-SUB I-SUB I-SUB O O O O O O O O O O O O O O O O O	任职
B-OBJ I-OBJ O O B-SUB I-SUB I-SUB O O O O O O O O O O O O O O O O O O O O O O O O O	任职
B-OBJ [##WordPiece] O O B-SUB I-SUB I-SUB I-SUB I-SUB I-SUB I-SUB I-SUB I-SUB O O O [##WordPiece] O O	任职
B-OBJ I-OBJ I-OBJ I-OBJ I-OBJ O O O O O O O B-SUB I-SUB I-SUB I-SUB I-SUB I-SUB I-SUB O O [##WordPiece] [##WordPiece] O [##WordPiece] O O O O O O O O O O O O O O O O	任职
B-OBJ I-OBJ I-OBJ O B-SUB I-SUB I-SUB I-SUB I-SUB I-SUB I-SUB O O O [##WordPiece] [##WordPiece] [##WordPiece] O O O O O O O O O O O O O O O [##WordPiece] O [##WordPiece] [##WordPiece] O O O O O O O O O O O O O O O O O	任职
O O O O O O O O O O O O O O [##WordPiece] [##WordPiece] [##WordPiece] O O B-OBJ I-OBJ I-OBJ O O B-SUB I-SUB I-SUB I-SUB I-SUB I-SUB O O [##WordPiece] O [##WordPiece] [##WordPiece] O O O O O O O O O O O O O O O O O	任职
B-OBJ I-OBJ O O B-SUB I-SUB I-SUB O O O O O O O O O O O O O O O O O O O O O O O O O O O O O [##WordPiece] O [##WordPiece] [##WordPiece] O O O O O O O O O [##WordPiece] O [##WordPiece] O [##WordPiece] [##WordPiece] O O O O O O O O O O O	任职
O O O O O O O O O O O O O O O O O O O O O O O O O O O O O O O O O O O O [##WordPiece] O [##WordPiece] [##WordPiece] O O O B-SUB I-SUB I-SUB I-SUB O O [##WordPiece] O [##WordPiece] O [##WordPiece] [##WordPiece] O O O B-OBJ I-OBJ I-OBJ I-OBJ O O O O	任职
O O O O O O O O O O O O O O O O O O O O O O O O B-SUB I-SUB I-SUB I-SUB I-SUB I-SUB I-SUB I-SUB I-SUB O O O [##WordPiece] O [##WordPiece] [##WordPiece] O O O O O O O O O [##WordPiece] O [##WordPiece] O [##WordPiece] [##WordPiece] O O O B-OBJ I-OBJ I-OBJ I-OBJ O O O O	任职
B-OBJ I-OBJ I-OBJ I-OBJ I-OBJ I-OBJ I-OBJ I-OBJ I-OBJ I-OBJ I-OBJ I-OBJ I-OBJ O O B-SUB I-SUB I-SUB	任职
O O B-OBJ I-OBJ I-OBJ I-OBJ I-OBJ O O O O O O O O O O O O O O O O O B-SUB I-SUB I-SUB O O O O O O O O O O O O O O O O O	任职
B-OBJ I-OBJ O O O B-SUB I-SUB I-SUB O O O O O O O O O O O O O O O O O O O O O O O O O O O O O O O O O O O	任职
B-OBJ I-OBJ O O O B-SUB I-SUB O O O O	任职
B-OBJ I-OBJ O O O B-SUB I-SUB I-SUB O O O O O O O O O O O O O O O O	任职
B-SUB I-SUB I-SUB O B-OBJ I-OBJ I-OBJ I-OBJ O O O O O O O	任职
B-OBJ I-OBJ I-OBJ I-OBJ O O O B-SUB I-SUB I-SUB I-SUB I-SUB I-SUB I-SUB O O	任职
B-OBJ I-OBJ O O O B-SUB I-SUB I-SUB O O O O O O O O O O O O O O O O O O O O O	任职
B-OBJ I-OBJ I-OBJ O O B-SUB I-SUB I-SUB I-SUB I-SUB O O O O O O O O O O O O	任职
B-OBJ I-OBJ I-OBJ O O O B-SUB I-SUB I-SUB I-SUB I-SUB I-SUB I-SUB I-SUB I-SUB O O O O O O O O O O O O O O O O O O O O O	任职
B-OBJ I-OBJ I-OBJ I-OBJ I-OBJ O O B-SUB I-SUB I-SUB I-SUB I-SUB I-SUB O O O O O O	任职
B-OBJ I-OBJ I-OBJ O O B-SUB I-SUB O O	任职
O O O O O O B-OBJ I-OBJ I-OBJ I-OBJ O O O O O B-SUB I-SUB I-SUB I-SUB I-SUB I-SUB I-SUB O O O O O O O O O O O O	任职
O O B-OBJ I-OBJ I-OBJ I-OBJ I-OBJ I-OBJ O O O O O O O O O O O O O O O B-SUB I-SUB I-SUB I-SUB I-SUB I-SUB I-SUB I-SUB O	任职
O B-OBJ I-OBJ O O B-SUB I-SUB I-SUB O O O O O O O O O O O O O O O O O O O O O	任职
B-OBJ I-OBJ I-OBJ I-OBJ I-OBJ I-OBJ O O B-SUB I-SUB I-SUB I-SUB I-SUB I-SUB I-SUB I-SUB I-SUB O O O O O O O O O O O O	任职
B-OBJ I-OBJ O O B-SUB I-SUB I-SUB O O O O O O O O O O O O O O O O O	任职
B-OBJ I-OBJ I-OBJ I-OBJ I-OBJ I-OBJ O O O O O B-SUB I-SUB I-SUB I-SUB I-SUB I-SUB I-SUB I-SUB I-SUB I-SUB O	任职
B-OBJ I-OBJ O O B-SUB I-SUB I-SUB O O O O O O O O O	任职
B-SUB I-SUB I-SUB O O O O O B-OBJ I-OBJ I-OBJ I-OBJ I-OBJ I-OBJ I-OBJ I-OBJ I-OBJ I-OBJ I-OBJ I-OBJ I-OBJ I-OBJ I-OBJ O O O O O O O	任职
B-SUB I-SUB I-SUB O O O O O O O O O O O O O O O O O O O O O B-OBJ I-OBJ I-OBJ I-OBJ I-OBJ I-OBJ	任职
B-SUB I-SUB I-SUB I-SUB I-SUB I-SUB I-SUB O O O O O O O O O O O B-OBJ I-OBJ I-OBJ I-OBJ I-OBJ I-OBJ I-OBJ I-OBJ I-OBJ I-OBJ I-OBJ I-OBJ I-OBJ	任职
B-SUB I-SUB I-SUB I-SUB I-SUB I-SUB I-SUB O O O B-OBJ I-OBJ I-OBJ I-OBJ I-OBJ I-OBJ I-OBJ I-OBJ I-OBJ O O O	任职
B-SUB I-SUB I-SUB O O O O O O O O O O B-OBJ I-OBJ I-OBJ I-OBJ I-OBJ I-OBJ I-OBJ I-OBJ I-OBJ I-OBJ I-OBJ I-OBJ I-OBJ O O O	任职
B-SUB I-SUB O O O O O O O O O O O O O O O O O O B-OBJ I-OBJ I-OBJ I-OBJ I-OBJ O O O O O O O O O O O	任职
O O O O O B-SUB I-SUB O O O O O O O B-OBJ I-OBJ I-OBJ I-OBJ I-OBJ I-OBJ I-OBJ I-OBJ O O	任职
B-OBJ I-OBJ I-OBJ I-OBJ I-OBJ I-OBJ I-OBJ I-OBJ I-OBJ I-OBJ I-OBJ I-OBJ I-OBJ O O O B-SUB I-SUB O O O O O O O O O O O O O O O O O O O O O O O	任职
B-OBJ I-OBJ I-OBJ I-OBJ O O O O B-SUB I-SUB I-SUB I-SUB I-SUB I-SUB I-SUB O O O O O O O	任职
B-OBJ [##WordPiece] I-OBJ [##WordPiece] O O O O O O O O B-SUB I-SUB I-SUB I-SUB I-SUB I-SUB I-SUB I-SUB O	任职
O O B-OBJ I-OBJ I-OBJ I-OBJ I-OBJ I-OBJ O O O O O B-SUB I-SUB	任职
B-OBJ I-OBJ I-OBJ I-OBJ I-OBJ I-OBJ I-OBJ I-OBJ I-OBJ O O B-SUB I-SUB I-SUB I-SUB I-SUB O O O O O	任职
B-OBJ I-OBJ I-OBJ I-OBJ I-OBJ I-OBJ I-OBJ I-OBJ I-OBJ O O O O O O O O B-SUB I-SUB I-SUB I-SUB	任职
B-OBJ I-OBJ O B-SUB I-SUB I-SUB O O O O O O O O O O O O O O O O O O O O O	任职
B-OBJ I-OBJ O O B-SUB I-SUB I-SUB O O O O O O O O O O	任职
B-OBJ I-OBJ I-OBJ O O O B-SUB I-SUB I-SUB O O O O	任职
B-OBJ I-OBJ O O O O O O O O O B-SUB I-SUB I-SUB I-SUB O O O O O O O O O	任职
B-OBJ I-OBJ I-OBJ I-OBJ I-OBJ I-OBJ I-OBJ I-OBJ I-OBJ O O O O O O O O O O O O O O O O B-SUB I-SUB I-SUB I-SUB I-SUB I-SUB	任职
B-SUB I-SUB I-SUB O O O O O B-OBJ I-OBJ O O O O	任职
B-OBJ I-OBJ I-OBJ I-OBJ I-OBJ I-OBJ I-OBJ I-OBJ O O O B-SUB I-SUB I-SUB I-SUB	任职
B-OBJ I-OBJ I-OBJ O O B-SUB I-SUB O O O O O O O O O O	任职
B-OBJ I-OBJ I-OBJ I-OBJ I-OBJ I-OBJ I-OBJ I-OBJ I-OBJ O O O O B-SUB I-SUB I-SUB I-SUB I-SUB I-SUB I-SUB	任职
B-OBJ I-OBJ I-OBJ I-OBJ I-OBJ I-OBJ I-OBJ I-OBJ I-OBJ I-OBJ I-OBJ O B-SUB I-SUB I-SUB I-SUB I-SUB I-SUB	任职
B-OBJ I-OBJ I-OBJ I-OBJ I-OBJ I-OBJ I-OBJ O O O O O B-SUB I-SUB I-SUB I-SUB I-SUB I-SUB O O O [##WordPiece] [##WordPiece] [##WordPiece] [##WordPiece] O O O O O O O	任职
B-OBJ I-OBJ O O O B-SUB I-SUB I-SUB I-SUB I-SUB O O O [##WordPiece] O O O	任职
B-OBJ I-OBJ I-OBJ I-OBJ I-OBJ I-OBJ I-OBJ I-OBJ I-OBJ I-OBJ I-OBJ I-OBJ I-OBJ I-OBJ O O B-SUB I-SUB I-SUB I-SUB I-SUB I-SUB O O O O O O O O O O O O O O O O	任职
B-OBJ I-OBJ I-OBJ O O B-SUB I-SUB I-SUB I-SUB O O O O O O O O O O O O O O O O O	任职
O O O O O O O O O O O O O O O O O O O B-OBJ I-OBJ O O B-SUB I-SUB I-SUB	任职
B-OBJ I-OBJ I-OBJ O O B-SUB I-SUB I-SUB O O O O O O O O O O O O O O O O O O O O O O O	任职
O B-OBJ I-OBJ O O O O O O O O O O O O O O O O O O O O O O O O O O O O O O O O O O O O O O O O O O B-SUB I-SUB I-SUB I-SUB I-SUB I-SUB O O O	任职
B-OBJ I-OBJ O O B-SUB I-SUB I-SUB O O O O O O O O O O O O O O O O O O O O	任职
B-OBJ I-OBJ O O O O O O O O O O O O O O O O O O O O O O O O O O O O O O O O O B-SUB I-SUB I-SUB I-SUB O O O O	任职
O B-OBJ I-OBJ I-OBJ I-OBJ I-OBJ I-OBJ I-OBJ O O B-SUB I-SUB I-SUB I-SUB I-SUB I-SUB I-SUB I-SUB I-SUB I-SUB I-SUB I-SUB	任职
B-OBJ I-OBJ I-OBJ I-OBJ I-OBJ O O O B-SUB I-SUB I-SUB I-SUB I-SUB I-SUB I-SUB I-SUB I-SUB I-SUB I-SUB O O O O O O O O O O	任职
O B-OBJ I-OBJ O O O B-SUB I-SUB I-SUB I-SUB I-SUB I-SUB I-SUB O O O O O O O O O O O O O	任职
B-OBJ I-OBJ O O O O O B-SUB I-SUB I-SUB I-SUB O O O O O	任职
B-OBJ I-OBJ I-OBJ I-OBJ I-OBJ I-OBJ I-OBJ I-OBJ I-OBJ I-OBJ I-OBJ O O O B-SUB I-SUB I-SUB O O O O O O O O O O O O O O O O O O O O O O O O O O	任职
B-OBJ I-OBJ I-OBJ I-OBJ I-OBJ I-OBJ I-OBJ I-OBJ I-OBJ I-OBJ I-OBJ I-OBJ I-OBJ I-OBJ O O O B-SUB I-SUB I-SUB O O O O O O O	任职
B-OBJ I-OBJ I-OBJ I-OBJ I-OBJ I-OBJ I-OBJ I-OBJ O O B-SUB I-SUB O O O O O O	任职
B-OBJ I-OBJ O O O O B-SUB I-SUB I-SUB I-SUB O O O O O O O O O	任职
B-OBJ I-OBJ I-OBJ I-OBJ I-OBJ I-OBJ I-OBJ I-OBJ I-OBJ I-OBJ O O O B-SUB I-SUB I-SUB O O O O O O O O	任职
B-OBJ I-OBJ O O O O O O O O B-SUB I-SUB O O O O O O O O O O O O	任职
B-OBJ I-OBJ B-SUB I-SUB I-SUB I-SUB O O O O O O O O	任职
B-OBJ I-OBJ I-OBJ O O O B-SUB I-SUB I-SUB O O O O O O O	任职
B-OBJ I-OBJ O O B-SUB I-SUB O O O O O O O O O O O O O O O O O O O O O	任职
B-OBJ I-OBJ I-OBJ I-OBJ I-OBJ I-OBJ O O B-SUB I-SUB O O O O O O O O O O O O O O O O O O O O O O	任职
O O O O O O O O O O O O O B-OBJ I-OBJ I-OBJ I-OBJ I-OBJ I-OBJ O O O O B-SUB I-SUB I-SUB O O O O O O	任职
O O B-OBJ I-OBJ I-OBJ O O O B-SUB I-SUB I-SUB I-SUB O O O O O O O O O O O O O O O O	任职
B-OBJ I-OBJ O O B-SUB I-SUB I-SUB O O O O O O O O O O	任职
B-OBJ I-OBJ O O B-SUB I-SUB I-SUB I-SUB O O O O O O O O O O O	任职
B-OBJ I-OBJ O O B-SUB I-SUB I-SUB O O O O O O O O O O O O O O O	任职
B-OBJ I-OBJ O O O O B-SUB I-SUB I-SUB I-SUB I-SUB I-SUB I-SUB O O O O O O O O O O O O O O	任职
B-OBJ I-OBJ I-OBJ O O B-SUB I-SUB I-SUB I-SUB O O O O O O O O O O O O O O O	任职
B-OBJ I-OBJ I-OBJ I-OBJ I-OBJ I-OBJ I-OBJ I-OBJ I-OBJ I-OBJ I-OBJ I-OBJ I-OBJ I-OBJ I-OBJ I-OBJ O O O O O O O O O O O O O O O O B-SUB I-SUB I-SUB I-SUB I-SUB I-SUB	任职
O O O O O O O O O O O O O O O O O B-OBJ I-OBJ I-OBJ I-OBJ I-OBJ I-OBJ I-OBJ I-OBJ I-OBJ I-OBJ I-OBJ O O O O B-SUB I-SUB I-SUB I-SUB I-SUB I-SUB	任职
B-OBJ I-OBJ I-OBJ I-OBJ I-OBJ O O O B-SUB I-SUB I-SUB I-SUB I-SUB I-SUB O O O O O O O O	任职
B-OBJ I-OBJ O O B-SUB I-SUB I-SUB O O O O	任职
O O O O O B-OBJ I-OBJ I-OBJ O O O B-SUB I-SUB I-SUB O O O O O O O O O O O O O O O O O	任职
B-OBJ I-OBJ I-OBJ I-OBJ O O O O B-SUB I-SUB I-SUB O O O O	任职
B-OBJ I-OBJ I-OBJ O O O B-SUB I-SUB I-SUB O O O O O O	任职
O O B-OBJ I-OBJ I-OBJ I-OBJ O O O O B-SUB I-SUB I-SUB I-SUB I-SUB I-SUB I-SUB O	任职
O O B-OBJ I-OBJ I-OBJ I-OBJ I-OBJ O O O O B-SUB I-SUB I-SUB I-SUB I-SUB O O	任职
B-OBJ I-OBJ I-OBJ O O B-SUB I-SUB I-SUB O O O O O O O O O O O O O O O O O O O O O O O O O O O O O O O O O O	任职
O O O O O O O O O B-OBJ I-OBJ I-OBJ O B-SUB I-SUB I-SUB O O O O O O O O O O O O O O O O O O O O O O O O O O	任职
O O O O O B-OBJ I-OBJ I-OBJ I-OBJ I-OBJ I-OBJ I-OBJ O O O O O O B-SUB I-SUB I-SUB I-SUB I-SUB I-SUB O O [##WordPiece] O [##WordPiece] [##WordPiece] O O O	任职
B-OBJ I-OBJ I-OBJ O O B-SUB I-SUB I-SUB O O O O O O O O O O O O O O O O O O O O O O O	任职
B-OBJ I-OBJ O O B-SUB I-SUB I-SUB O O O O O O O O O O O O O O O O O O O O O O O O	任职
B-OBJ I-OBJ O O B-SUB I-SUB I-SUB O O O O O O O O O O	任职
O O O O B-OBJ I-OBJ I-OBJ I-OBJ I-OBJ I-OBJ I-OBJ I-OBJ I-OBJ O O O O O O O O O O O O O O B-SUB I-SUB I-SUB I-SUB I-SUB O O O	任职
O O B-OBJ I-OBJ O O B-SUB I-SUB I-SUB O O O O O	任职
B-OBJ I-OBJ I-OBJ O O O O O B-SUB I-SUB O O O O O O O O O O O	任职
B-OBJ I-OBJ O O O B-SUB I-SUB I-SUB I-SUB I-SUB O O O O O O O O O O O O O O O O O	任职
B-OBJ I-OBJ I-OBJ O O B-SUB I-SUB I-SUB I-SUB O O O	任职
B-OBJ I-OBJ O O B-SUB I-SUB I-SUB O O O O O O O	任职
O O B-OBJ I-OBJ I-OBJ O B-SUB I-SUB I-SUB O O O O O O O O O O O O O O	任职
B-OBJ I-OBJ I-OBJ O O O B-SUB I-SUB I-SUB I-SUB I-SUB I-SUB I-SUB I-SUB O O [##WordPiece] [##WordPiece] O O O O O O O O O O O O O O O O O	任职
B-OBJ I-OBJ O O O O O O O O O O O O O B-SUB I-SUB I-SUB	任职
O O O O O O O O O O O O O O O O O O O B-OBJ I-OBJ I-OBJ O O O O O B-SUB I-SUB	任职
O B-OBJ O O B-SUB I-SUB I-SUB I-SUB I-SUB I-SUB I-SUB O O O O O O O O O O	任职
B-OBJ I-OBJ I-OBJ I-OBJ I-OBJ I-OBJ O O B-SUB I-SUB I-SUB O O O O O O O O O O O O O O O O O O O O	任职
B-OBJ I-OBJ I-OBJ O O O B-SUB I-SUB I-SUB I-SUB O O O	任职
B-OBJ I-OBJ I-OBJ O O O B-SUB I-SUB I-SUB O O O O O O	任职
B-OBJ I-OBJ I-OBJ O O B-SUB I-SUB I-SUB O O O O O O O O O O O O O O O O O O O O O O O	任职
B-OBJ I-OBJ I-OBJ O O O B-SUB I-SUB I-SUB O O O O	任职
B-OBJ I-OBJ O O O O O O O O O B-SUB I-SUB I-SUB I-SUB O O O O O O O O O	任职
B-OBJ I-OBJ O O O O O O B-SUB I-SUB I-SUB O O O O O O O O O O O O O O O O O O O O O O O O O	任职
B-OBJ I-OBJ O O O O O O B-SUB I-SUB I-SUB O O O O O O	任职
O O O O O O O O B-OBJ I-OBJ I-OBJ I-OBJ I-OBJ O B-SUB I-SUB O O O O	任职
B-OBJ I-OBJ I-OBJ O O O O O O O O O O O O O O O B-SUB I-SUB I-SUB O O O O O O	任职
B-OBJ I-OBJ O O O O O O B-SUB I-SUB I-SUB O O O O O O O O O O O	任职
B-OBJ I-OBJ O O O O O O B-SUB I-SUB I-SUB O O	任职
B-OBJ I-OBJ O O O O O O B-SUB I-SUB I-SUB O O O O O O O O O O O	任职
O B-OBJ I-OBJ I-OBJ O O O B-SUB I-SUB I-SUB O O O O O O	任职
B-OBJ I-OBJ O O O O O O B-SUB I-SUB I-SUB O O O	任职
B-OBJ I-OBJ I-OBJ O O O O O B-SUB I-SUB I-SUB O O O O O O O O O O O O O O O O	任职
B-OBJ I-OBJ I-OBJ I-OBJ I-OBJ I-OBJ I-OBJ I-OBJ I-OBJ I-OBJ I-OBJ O O O O O O O O B-SUB I-SUB I-SUB	任职
B-OBJ I-OBJ O O O O B-SUB I-SUB I-SUB O O O O O O O O O O	任职
B-OBJ I-OBJ I-OBJ I-OBJ I-OBJ I-OBJ I-OBJ I-OBJ O O B-SUB I-SUB I-SUB O O	任职
B-OBJ I-OBJ I-OBJ O O O B-SUB I-SUB I-SUB O O O O O O O O O O O O O O O O	任职
B-OBJ I-OBJ I-OBJ I-OBJ I-OBJ I-OBJ B-SUB I-SUB I-SUB O O O O O	任职
O O O O O O O B-OBJ I-OBJ I-OBJ I-OBJ I-OBJ O O B-SUB I-SUB I-SUB O O O O O O O O O O O O O O O O O O O O O O O O O	任职
B-OBJ I-OBJ I-OBJ O O O B-SUB I-SUB I-SUB O O O O O O O	任职
B-OBJ I-OBJ I-OBJ O O O B-SUB I-SUB I-SUB	任职
B-OBJ I-OBJ I-OBJ O O O O O B-SUB I-SUB I-SUB O O O O	任职
O O O O O O O O O O B-OBJ I-OBJ I-OBJ I-OBJ O O B-SUB I-SUB O O O O O O O O O O O	任职
B-OBJ I-OBJ I-OBJ I-OBJ I-OBJ I-OBJ I-OBJ O O O O O O O O O B-SUB I-SUB O O O O O O O O O O O	任职
O O O O O O O B-OBJ I-OBJ I-OBJ I-OBJ I-OBJ O O B-SUB I-SUB I-SUB O O O O O O O O O O O O O O O O O O O O O O O O O O O O	任职
B-OBJ I-OBJ I-OBJ I-OBJ I-OBJ I-OBJ O O O O O O O O B-SUB I-SUB I-SUB O O O O O O O O O O O O O O O O O O O O O O O O O O O O	任职
B-OBJ I-OBJ I-OBJ O O O B-SUB I-SUB I-SUB O O O O O O O	任职
B-OBJ I-OBJ I-OBJ I-OBJ I-OBJ I-OBJ I-OBJ I-OBJ O O O O B-SUB I-SUB I-SUB O O O O O O O O	任职
B-OBJ I-OBJ I-OBJ I-OBJ O O O O O B-SUB I-SUB I-SUB O O O O O	任职
O O B-OBJ I-OBJ I-OBJ I-OBJ I-OBJ I-OBJ I-OBJ O O O B-SUB I-SUB I-SUB O O	任职
B-OBJ I-OBJ I-OBJ O O O O O B-SUB I-SUB I-SUB O O O O	任职
B-OBJ I-OBJ I-OBJ I-OBJ O O O O O B-SUB I-SUB I-SUB O O O O O O	任职
B-OBJ I-OBJ O O O O O O O O B-SUB I-SUB O O	任职
O O O O O B-OBJ I-OBJ O O O O O O O B-SUB I-SUB I-SUB O O O O O O	任职
B-OBJ I-OBJ I-OBJ O O O B-SUB I-SUB I-SUB O O O O O O O O O O O O O O O O O O O O	任职
B-OBJ I-OBJ I-OBJ O O O B-SUB I-SUB I-SUB O O O O O O O O O O O O O O O O O O O O O O O O O O O O O O O O O	任职
B-OBJ I-OBJ O O B-SUB I-SUB I-SUB O O O O O O O O O O O O O O O O O O	任职
O O O O O O O O B-OBJ I-OBJ I-OBJ O O O O O O O O B-SUB I-SUB I-SUB O O	任职
O B-OBJ I-OBJ I-OBJ O O O B-SUB I-SUB I-SUB O O O O O O O O O O	任职
B-OBJ I-OBJ I-OBJ I-OBJ I-OBJ I-OBJ O O O O O O O B-SUB I-SUB I-SUB O O	任职
B-OBJ I-OBJ O O O O B-SUB I-SUB O O O O O O O O O O	任职
B-OBJ I-OBJ I-OBJ I-OBJ I-OBJ I-OBJ I-OBJ I-OBJ O O O B-SUB I-SUB I-SUB O O O O O O O O O O	任职
B-OBJ I-OBJ I-OBJ I-OBJ O O O B-SUB I-SUB I-SUB O O	任职
B-OBJ I-OBJ I-OBJ O O O B-SUB I-SUB I-SUB O O O O O O O O O O O O O O O O O O O O O O O O	任职
B-OBJ I-OBJ O O B-SUB I-SUB I-SUB I-SUB O O O O O O O O O O O O O O O	任职
B-OBJ I-OBJ I-OBJ O O O B-SUB I-SUB I-SUB O O O O O O O O O O O O O O O O O	任职
B-OBJ I-OBJ I-OBJ I-OBJ I-OBJ I-OBJ I-OBJ O O O B-SUB I-SUB I-SUB O O O O O O O O	任职
B-OBJ I-OBJ I-OBJ O O O B-SUB I-SUB I-SUB O O O O O O O	任职
O O O O O O O B-OBJ I-OBJ O O O O O O O O O O O B-SUB I-SUB I-SUB O O O O O O O O	任职
B-OBJ I-OBJ O O O O B-SUB I-SUB I-SUB O O O O O O O O O O O O O O O O	任职
B-OBJ I-OBJ I-OBJ O O O B-SUB I-SUB I-SUB O O O O O O O	任职
O O O O O O O O O O B-SUB I-SUB I-SUB O B-OBJ I-OBJ O O O O O O	任职
O B-OBJ I-OBJ I-OBJ O O O B-SUB I-SUB O O O O O O O O O O O O O O O O	任职
B-OBJ I-OBJ I-OBJ I-OBJ I-OBJ I-OBJ O O O O O O O O O O O O B-SUB I-SUB I-SUB O O O O O O	任职
B-OBJ I-OBJ I-OBJ O B-SUB I-SUB I-SUB O O O O O O O O O O O O O O O O O O O O O O O O O O O	任职
O O O O O O O O B-OBJ I-OBJ I-OBJ O O O O O O O O B-SUB I-SUB I-SUB O O O O O O O	任职
B-OBJ I-OBJ I-OBJ O O O B-SUB I-SUB I-SUB O O O O O O O O O O O O O O O O O O O O O O O O O O O O O O O O	任职
O O O O B-OBJ I-OBJ O O O O O O B-SUB I-SUB I-SUB	任职
B-OBJ I-OBJ I-OBJ O O O O O B-SUB I-SUB I-SUB O O O O O O O	任职
B-OBJ I-OBJ I-OBJ O O O B-SUB I-SUB I-SUB O O O O O O O O	任职
O O O O O O O O O O B-OBJ I-OBJ I-OBJ O O B-SUB I-SUB I-SUB O O O O O O O O O O O O O O O O O	任职
B-OBJ I-OBJ I-OBJ O O O O O O O B-SUB I-SUB I-SUB O O O O O O O O O O O	任职
B-OBJ I-OBJ O O O O O B-SUB I-SUB I-SUB I-SUB I-SUB O O O O O O O O O O O O O O O O O O O O O	任职
B-OBJ I-OBJ I-OBJ O O O B-SUB I-SUB I-SUB O O O	任职
O B-OBJ I-OBJ I-OBJ O O O B-SUB I-SUB I-SUB O O O O O O O O	任职
B-OBJ I-OBJ I-OBJ I-OBJ O O O O B-SUB I-SUB I-SUB I-SUB O O O O O O O O O O O O O O	任职
B-OBJ I-OBJ I-OBJ O O O B-SUB I-SUB I-SUB O O O O O O O O O O O O O O O O O O O O	任职
O O O O O O B-OBJ I-OBJ I-OBJ O O B-SUB I-SUB I-SUB I-SUB I-SUB I-SUB O O O O O O O O O O O O O O O O O O O	任职
B-OBJ I-OBJ I-OBJ I-OBJ I-OBJ I-OBJ I-OBJ I-OBJ I-OBJ O O [##WordPiece] O O O O B-SUB I-SUB I-SUB I-SUB I-SUB I-SUB O O O O O O O O O O O O O O O O O O O O O O O [##WordPiece] [##WordPiece] O O O O O	任职
O [##WordPiece] [##WordPiece] O O [##WordPiece] [##WordPiece] O O O O O B-OBJ I-OBJ I-OBJ I-OBJ I-OBJ I-OBJ I-OBJ I-OBJ O O O	任职
B-OBJ I-OBJ I-OBJ I-OBJ I-OBJ O O B-SUB I-SUB I-SUB I-SUB I-SUB O O O O O O O O O O O O	任职
O O O O O B-OBJ I-OBJ I-OBJ O O O B-SUB I-SUB I-SUB I-SUB I-SUB I-SUB I-SUB I-SUB I-SUB O O O O O O O O O O O	任职
O B-OBJ I-OBJ I-OBJ I-OBJ I-OBJ I-OBJ I-OBJ I-OBJ I-OBJ I-OBJ I-OBJ I-OBJ I-OBJ O O B-SUB I-SUB I-SUB I-SUB I-SUB I-SUB I-SUB I-SUB I-SUB O O O O O O O O O O O O O O O O O O O O O O O O O O	任职
O O O B-OBJ I-OBJ I-OBJ I-OBJ I-OBJ I-OBJ I-OBJ I-OBJ I-OBJ I-OBJ I-OBJ I-OBJ I-OBJ O O B-SUB I-SUB I-SUB I-SUB I-SUB I-SUB I-SUB I-SUB I-SUB O O O O O O O O O O	任职
B-OBJ I-OBJ I-OBJ I-OBJ I-OBJ [##WordPiece] I-OBJ I-OBJ I-OBJ I-OBJ O O O B-SUB I-SUB I-SUB I-SUB I-SUB I-SUB I-SUB I-SUB O O O O O O O O O O O O O O O	任职
B-OBJ I-OBJ I-OBJ I-OBJ O O O O O O O O O O O O O O O O O O O O O O O O O O O B-SUB I-SUB I-SUB I-SUB I-SUB I-SUB I-SUB O O O	任职
O O O O O O O O O O O O O O O O O B-OBJ I-OBJ I-OBJ I-OBJ I-OBJ I-OBJ I-OBJ I-OBJ I-OBJ I-OBJ I-OBJ I-OBJ I-OBJ I-OBJ I-OBJ O O O O B-SUB I-SUB I-SUB I-SUB I-SUB I-SUB I-SUB O O O O O O O O O O O O O O O O O O O O O O O O O O O O O	任职
B-OBJ I-OBJ O O O B-SUB I-SUB I-SUB O O O O O O O O O O O O O O O O O O O O O O O O O O O O O O O	任职
O O O O O O O O O O B-OBJ I-OBJ O O B-SUB I-SUB I-SUB O O O O O O O O O O O O O O O O O O O O O O O O O O O O O O O O O O O O O O O O O O O O O O O O O O O O O O O O O	任职
B-OBJ I-OBJ O O O B-SUB I-SUB I-SUB I-SUB I-SUB O O O O O	任职
O B-OBJ I-OBJ O O O O O O O O O O O O O O O O O B-SUB I-SUB I-SUB O O O O O O O O O O O O O O O O O O O O O O O O O O O O O O O O O O O O O O O O O O O O O O O O O O	任职
B-OBJ I-OBJ I-OBJ I-OBJ O O O O B-SUB I-SUB I-SUB O O O O O O	任职
B-OBJ I-OBJ I-OBJ I-OBJ I-OBJ O B-SUB I-SUB I-SUB I-SUB I-SUB I-SUB O O O O O O O O O O O O O O O O O O O O O O O O O O O O O O O O O O O [##WordPiece] [##WordPiece] [##WordPiece] O O O O O O O O O O O O O O O	任职
B-OBJ I-OBJ I-OBJ O O O O O O O O O O O O O O O B-SUB I-SUB I-SUB I-SUB I-SUB O O O O O O	任职
B-OBJ I-OBJ I-OBJ I-OBJ O B-SUB I-SUB I-SUB I-SUB I-SUB O O O O O O O O O O O O O O	任职
O O O O O O O O O O O O O O O O B-OBJ I-OBJ O O B-SUB I-SUB I-SUB O O O O O O	任职
B-OBJ I-OBJ I-OBJ I-OBJ I-OBJ O O O O O O O O O O B-SUB I-SUB I-SUB I-SUB I-SUB I-SUB I-SUB O O O O	任职
O O O B-OBJ I-OBJ I-OBJ O O O O O O O B-SUB I-SUB I-SUB I-SUB I-SUB I-SUB O O O O O O O O O O O O O O O O O O O O O O	任职
O B-OBJ I-OBJ I-OBJ O B-SUB I-SUB I-SUB I-SUB I-SUB I-SUB O O O O O O O O O O O O O O O O O O O	任职
O O O O O O O O O O O O O O B-OBJ I-OBJ O O B-SUB I-SUB I-SUB O O O O O O O	任职
O O O O O O O O O O O O O O B-OBJ I-OBJ I-OBJ O O O O O B-SUB I-SUB I-SUB I-SUB I-SUB I-SUB I-SUB I-SUB I-SUB O O O O O O O O O O O O O O O O O O O O O O O O O O O O O O O O O O O O O O O O O	任职
B-OBJ I-OBJ I-OBJ O O O O O O O O O O B-SUB I-SUB I-SUB I-SUB I-SUB I-SUB I-SUB I-SUB O O O O O O O O O O O O O	任职
B-OBJ I-OBJ I-OBJ O O O O O B-SUB I-SUB I-SUB I-SUB O O O O O	任职
B-OBJ I-OBJ I-OBJ I-OBJ I-OBJ I-OBJ I-OBJ I-OBJ I-OBJ I-OBJ I-OBJ I-OBJ I-OBJ O O B-SUB I-SUB I-SUB I-SUB O O O O	任职
O O O B-OBJ I-OBJ I-OBJ I-OBJ O O B-SUB I-SUB I-SUB I-SUB I-SUB O O O	任职
B-OBJ I-OBJ O O O O O O O B-SUB I-SUB I-SUB I-SUB I-SUB I-SUB I-SUB O O O O O O O	任职
O B-OBJ I-OBJ O O O O O O O O O O O O O O O O O O O O O O O O O O O O O O O O O O O O B-SUB I-SUB I-SUB I-SUB I-SUB I-SUB O O O O O O O O O O O O O O O O O O O O O O O O O O	任职
O O O O O O O O O O O O B-OBJ I-OBJ I-OBJ I-OBJ I-OBJ I-OBJ I-OBJ I-OBJ I-OBJ I-OBJ I-OBJ O O O O O O O O O O O B-SUB I-SUB I-SUB I-SUB I-SUB I-SUB I-SUB I-SUB I-SUB O O O	任职
O O O O O O O O O O O O O B-OBJ I-OBJ I-OBJ I-OBJ I-OBJ O O O O B-SUB I-SUB I-SUB I-SUB I-SUB O O	任职
B-OBJ I-OBJ O O O B-SUB I-SUB I-SUB I-SUB I-SUB I-SUB I-SUB O O O O O O O O O O O O O O O O O O O O O O O O O O O O O O O O O O O O O	任职
B-OBJ I-OBJ I-OBJ I-OBJ I-OBJ I-OBJ I-OBJ I-OBJ O O O O O O O B-SUB I-SUB I-SUB I-SUB I-SUB I-SUB I-SUB I-SUB I-SUB O	任职
B-OBJ I-OBJ I-OBJ I-OBJ I-OBJ I-OBJ I-OBJ I-OBJ I-OBJ I-OBJ I-OBJ I-OBJ I-OBJ O O B-SUB I-SUB I-SUB I-SUB I-SUB I-SUB O O O O O O O O O O O O O O O O O O O O O O O O O O O O O O O O O O O O	任职
B-OBJ I-OBJ O O O O O O O O O O O B-SUB I-SUB I-SUB O O O O O O O O O O O O O O O O O O O	任职
O O O B-OBJ I-OBJ O O O O B-SUB I-SUB O O O O O O O O O O O O O O	任职
O O O B-OBJ I-OBJ O O O O O O O O O O O O B-SUB I-SUB I-SUB O O O O O	任职
O O B-OBJ I-OBJ I-OBJ O O O O O O O O O O O B-SUB I-SUB I-SUB O O O O	任职
O O O O O O O O O O O O O B-OBJ I-OBJ I-OBJ I-OBJ I-OBJ I-OBJ I-OBJ I-OBJ O O B-SUB I-SUB I-SUB O O O O O O O O O	任职
B-OBJ I-OBJ I-OBJ O O B-SUB I-SUB I-SUB O O O O O O O O O O O O O O O O O O	任职
B-OBJ I-OBJ I-OBJ O O O B-SUB I-SUB I-SUB O O O O O O O O O O O O O O O	任职
B-OBJ I-OBJ I-OBJ I-OBJ I-OBJ I-OBJ I-OBJ I-OBJ B-SUB I-SUB I-SUB O O O O O O O O	任职
B-OBJ I-OBJ O O O O O O O O O O O [##WordPiece] [##WordPiece] O O O O O B-SUB I-SUB I-SUB I-SUB O O O O O O O	任职
B-OBJ I-OBJ O O O O O O O B-SUB I-SUB I-SUB I-SUB I-SUB I-SUB I-SUB O O O O O O	任职
O O O B-OBJ I-OBJ O O O O O B-SUB I-SUB I-SUB O O O O O O	任职
O O O O O B-OBJ I-OBJ I-OBJ O O B-SUB I-SUB I-SUB O O O O O	任职
O O O O O B-OBJ I-OBJ I-OBJ O O O B-SUB I-SUB I-SUB	任职
B-OBJ I-OBJ I-OBJ I-OBJ I-OBJ I-OBJ I-OBJ I-OBJ I-OBJ I-OBJ I-OBJ I-OBJ I-OBJ I-OBJ O O O B-SUB I-SUB I-SUB O O	任职
B-OBJ I-OBJ I-OBJ O O B-SUB I-SUB I-SUB O O O	任职
B-OBJ I-OBJ I-OBJ I-OBJ I-OBJ I-OBJ I-OBJ O O O B-SUB I-SUB I-SUB O O	任职
B-OBJ I-OBJ I-OBJ O O B-SUB I-SUB I-SUB O O O	任职
B-OBJ I-OBJ I-OBJ I-OBJ I-OBJ I-OBJ I-OBJ O O O B-SUB I-SUB I-SUB O O O O O O O O	任职
O O O B-OBJ I-OBJ I-OBJ O O O B-SUB I-SUB I-SUB O O	任职
B-OBJ I-OBJ O O O O B-SUB I-SUB I-SUB O O O O O O O O O O O O O O O O O O O O O O O O O O O O O O O O O O O O O O O	任职
O O O O O O O O O O O O O O O O O O O B-OBJ I-OBJ O O B-SUB I-SUB I-SUB O O O O O O O O O O O O O O O O O O O O O O	任职
O O O O O O O O O O O O O O O O O O O B-OBJ I-OBJ O O O O O O O O O B-SUB I-SUB I-SUB O O O O O O O O O O O O O O O	任职
O O O O O O O O O O O O O O O O O O O O O O O O O O O O O O O O O O B-OBJ I-OBJ I-OBJ O O O O B-SUB I-SUB I-SUB O O O O	任职
B-OBJ I-OBJ O O B-SUB I-SUB I-SUB O O O O O	任职
B-OBJ I-OBJ O O B-SUB I-SUB I-SUB O O O O	任职
O O O B-OBJ I-OBJ O O B-SUB I-SUB I-SUB O	任职
B-OBJ I-OBJ O O O O B-SUB I-SUB I-SUB O O O O O O O O O O O O O O O O O O O O O O O O O O O O O O O O O O O O O	任职
B-OBJ I-OBJ O O O O O B-SUB I-SUB I-SUB O O O	任职
B-OBJ I-OBJ I-OBJ I-OBJ O O B-SUB I-SUB I-SUB O	任职
B-OBJ I-OBJ O O B-SUB I-SUB I-SUB O O O O O O O O O O O O	任职
B-OBJ I-OBJ I-OBJ O O B-SUB I-SUB I-SUB O O O O O O O O O O O O O O O O	任职
B-OBJ I-OBJ O O O O O B-SUB I-SUB I-SUB O O O O O O O O O O O O O O O O O O O O O O O O O O O O O O	任职
O O O O O O O O O O O O O O O O O O O O O B-OBJ I-OBJ O O O O O B-SUB I-SUB I-SUB O O O O O O O O O	任职
O O O O O O O O O O O O O O O B-SUB I-SUB I-SUB I-SUB I-SUB I-SUB O O O O B-OBJ I-OBJ I-OBJ I-OBJ I-OBJ I-OBJ I-OBJ I-OBJ I-OBJ O O	任职
B-OBJ I-OBJ O O B-SUB I-SUB I-SUB I-SUB I-SUB I-SUB O O O O	任职
B-OBJ I-OBJ O O O O B-SUB I-SUB I-SUB O O O O O O O O	任职
B-OBJ I-OBJ O O O B-SUB I-SUB I-SUB I-SUB I-SUB I-SUB O O O O O O O O O O O O O O O	任职
O O O O O O O O O B-OBJ I-OBJ I-OBJ O O O B-SUB I-SUB I-SUB I-SUB I-SUB I-SUB I-SUB O O [##WordPiece] O [##WordPiece] [##WordPiece] O [##WordPiece] O [##WordPiece] [##WordPiece] [##WordPiece] O O O	任职
O B-OBJ I-OBJ O O O B-SUB I-SUB O O O O O O O O O O O O O O O O O O O O O O O O O	任职
O O O O O O O O O B-OBJ I-OBJ I-OBJ I-OBJ I-OBJ O O O B-SUB I-SUB I-SUB O O O O O O O O O O O O O	任职
O O O O O O O O O O O O O O O O O O O O O B-OBJ I-OBJ I-OBJ I-OBJ I-OBJ O O O B-SUB I-SUB O O	任职
B-OBJ I-OBJ I-OBJ I-OBJ I-OBJ I-OBJ I-OBJ I-OBJ I-OBJ O O O B-SUB I-SUB I-SUB I-SUB O O O O O O O O O O O	任职
B-OBJ I-OBJ I-OBJ O O B-SUB I-SUB I-SUB O O O O O O O O	任职
B-OBJ I-OBJ I-OBJ I-OBJ I-OBJ I-OBJ I-OBJ O O O O O B-SUB I-SUB I-SUB I-SUB I-SUB I-SUB O O O [##WordPiece] [##WordPiece] [##WordPiece] [##WordPiece] O O O O O O O	任职
B-OBJ I-OBJ I-OBJ O O O B-SUB I-SUB O O O O O O O O	任职
B-OBJ I-OBJ I-OBJ O O O B-SUB I-SUB O O O O O O O O O O O O O O O O O O	任职
B-OBJ I-OBJ I-OBJ I-OBJ O O O O B-SUB I-SUB I-SUB O O O O O O O O O O O	任职
B-OBJ I-OBJ O O B-SUB I-SUB I-SUB O O O O O O O O O O O O O O O O O O O O O O O O O O O O	任职
O O O O O O O B-OBJ I-OBJ I-OBJ O O O B-SUB I-SUB I-SUB I-SUB O O O O O O O O O O O O O O O O O	任职
B-OBJ I-OBJ I-OBJ I-OBJ I-OBJ O O B-SUB I-SUB O O O O O O O O O	任职
B-OBJ I-OBJ I-OBJ O O B-SUB I-SUB O	任职
O O O O B-OBJ I-OBJ I-OBJ O O O O O O O O B-SUB I-SUB O O O O O O O O	任职
O B-OBJ I-OBJ I-OBJ I-OBJ I-OBJ I-OBJ O O O B-SUB I-SUB I-SUB I-SUB O O O O O	任职
B-OBJ I-OBJ I-OBJ I-OBJ I-OBJ I-OBJ I-OBJ I-OBJ O O B-SUB I-SUB I-SUB O O O O O O	任职
O O O O B-OBJ I-OBJ I-OBJ O O O B-SUB I-SUB I-SUB O O O	任职
B-OBJ I-OBJ O O B-SUB I-SUB I-SUB O O O O O O O O O O O O O O O O	任职
B-OBJ I-OBJ I-OBJ O B-SUB I-SUB O O O O O	任职
O B-OBJ I-OBJ I-OBJ I-OBJ O O B-SUB I-SUB I-SUB O O O O O	任职
B-OBJ I-OBJ I-OBJ I-OBJ I-OBJ O B-SUB I-SUB I-SUB O O	任职
B-OBJ I-OBJ I-OBJ I-OBJ I-OBJ O B-SUB I-SUB I-SUB O O O O O O O O O O O O O O	任职
B-OBJ I-OBJ I-OBJ O O O B-SUB I-SUB I-SUB I-SUB O O O	任职
O O O O O O O O O O B-OBJ I-OBJ O O O B-SUB I-SUB I-SUB I-SUB O O	任职
O B-OBJ I-OBJ I-OBJ I-OBJ I-OBJ I-OBJ O O O O B-SUB I-SUB I-SUB O O O O O	任职
B-OBJ I-OBJ I-OBJ I-OBJ I-OBJ I-OBJ I-OBJ O O O O O B-SUB I-SUB I-SUB I-SUB I-SUB I-SUB O O O O O	任职
B-OBJ I-OBJ I-OBJ I-OBJ I-OBJ O O B-SUB I-SUB I-SUB O O O O O O O O O O O O O	任职
O O O O O O O O B-OBJ I-OBJ O O B-SUB I-SUB I-SUB O O O O O O O O	任职
B-OBJ I-OBJ I-OBJ I-OBJ I-OBJ O O O B-SUB I-SUB I-SUB O O	任职
B-OBJ I-OBJ I-OBJ I-OBJ O O O B-SUB I-SUB I-SUB I-SUB O O O O O O	任职
O O B-OBJ I-OBJ I-OBJ O O O B-SUB I-SUB O O O O O O O O O O O O O O O O	任职
O O O O B-SUB I-SUB I-SUB I-SUB O O O O O O O O B-OBJ I-OBJ I-OBJ I-OBJ I-OBJ O O O O	任职
O O O O O O O O O O B-OBJ I-OBJ I-OBJ O O O B-SUB I-SUB I-SUB I-SUB I-SUB O O O O	任职
O O B-OBJ I-OBJ I-OBJ O O O O O O O O O O O O O O O B-SUB I-SUB I-SUB I-SUB I-SUB I-SUB I-SUB O O O	任职
O O O O O O O O O O O O B-OBJ I-OBJ O O O O B-SUB I-SUB I-SUB O O O O O O O	任职
B-OBJ I-OBJ O O B-SUB I-SUB I-SUB O O O O O O O O O O O O O O O O O O O	任职
O B-OBJ I-OBJ O O O O B-SUB I-SUB I-SUB O O O O O O O O O	任职
B-OBJ I-OBJ O O O O O O O O O O O O B-SUB I-SUB I-SUB O O O O	任职
B-OBJ I-OBJ I-OBJ I-OBJ I-OBJ O O B-SUB I-SUB I-SUB O O O O O O	任职
B-OBJ I-OBJ O O O O O O O B-SUB I-SUB I-SUB I-SUB O O O O	任职
O O O O O B-OBJ I-OBJ I-OBJ I-OBJ I-OBJ I-OBJ I-OBJ I-OBJ I-OBJ O O B-SUB I-SUB I-SUB O O O O	任职
B-OBJ I-OBJ O O O B-SUB I-SUB I-SUB O O O O O O O O O	任职
B-OBJ I-OBJ O O O B-SUB I-SUB I-SUB O O O	任职
B-OBJ I-OBJ I-OBJ O O O B-SUB I-SUB I-SUB O O	任职
O O O O B-OBJ I-OBJ I-OBJ O O B-SUB I-SUB I-SUB I-SUB O O O O O O O	任职
O B-OBJ I-OBJ I-OBJ O B-SUB I-SUB I-SUB O O O O O O O O O O O O O	任职
B-OBJ I-OBJ I-OBJ I-OBJ I-OBJ O O B-SUB I-SUB I-SUB O O O O O O O O O O O	任职
B-OBJ I-OBJ I-OBJ O O O B-SUB I-SUB I-SUB O O O	任职
O O O O B-OBJ I-OBJ O O O O O O B-SUB I-SUB I-SUB O O O O O O O O O	任职
B-OBJ I-OBJ I-OBJ O O B-SUB I-SUB I-SUB O O	任职
B-OBJ I-OBJ I-OBJ I-OBJ I-OBJ O O B-SUB I-SUB I-SUB O O	任职
O O B-OBJ I-OBJ I-OBJ O O O O B-SUB I-SUB I-SUB O O O O O O O O O O O O O	任职
O B-SUB I-SUB I-SUB O O O O O O O B-OBJ I-OBJ O O O O O O O O O O O O O O O O O O	任职
O O O O O O O O O O O B-OBJ I-OBJ O O O O O B-SUB I-SUB I-SUB	任职
O B-OBJ I-OBJ I-OBJ I-OBJ I-OBJ O B-SUB I-SUB I-SUB O O O O O O O O O O	任职
B-OBJ I-OBJ O O O O O O B-SUB I-SUB I-SUB O O	任职
B-OBJ I-OBJ I-OBJ I-OBJ I-OBJ I-OBJ I-OBJ I-OBJ I-OBJ O O O O O O O O O O O O B-SUB I-SUB I-SUB O O O	任职
B-OBJ I-OBJ O O O B-SUB I-SUB I-SUB	任职
O O B-OBJ I-OBJ O O B-SUB I-SUB I-SUB	任职
B-OBJ I-OBJ O O O B-SUB I-SUB I-SUB O O O O O O O O O O O O O	任职
B-OBJ I-OBJ O O O O O O O O B-SUB I-SUB I-SUB O O O O O O O O O	任职
B-OBJ I-OBJ I-OBJ I-OBJ I-OBJ O O O B-SUB I-SUB I-SUB	任职
B-OBJ I-OBJ I-OBJ I-OBJ I-OBJ O O B-SUB I-SUB I-SUB	任职
B-OBJ I-OBJ I-OBJ I-OBJ I-OBJ O O B-SUB I-SUB I-SUB	任职
B-OBJ I-OBJ I-OBJ O O O B-SUB I-SUB I-SUB O O	任职
B-OBJ I-OBJ O O O O O O O O O O O B-SUB I-SUB I-SUB O O O O O O O O	任职
B-OBJ I-OBJ I-OBJ I-OBJ I-OBJ O O O O O O O O O O O O O O O O O O B-SUB I-SUB I-SUB	任职
B-OBJ I-OBJ I-OBJ O O O B-SUB I-SUB I-SUB O O	任职
B-OBJ I-OBJ I-OBJ I-OBJ I-OBJ O O O B-SUB I-SUB I-SUB O O O O O O O O O O O O O O O O	任职
B-OBJ I-OBJ I-OBJ I-OBJ I-OBJ I-OBJ I-OBJ I-OBJ I-OBJ I-OBJ O O B-SUB I-SUB I-SUB O O O [##WordPiece] [##WordPiece] O O O	任职
B-OBJ I-OBJ I-OBJ I-OBJ I-OBJ O O O B-SUB I-SUB I-SUB O O O O	任职
O B-OBJ I-OBJ I-OBJ I-OBJ I-OBJ O O O O O O O O O O O O B-SUB I-SUB I-SUB	任职
B-OBJ I-OBJ I-OBJ O O B-SUB I-SUB I-SUB O O O O O O O O O O	任职
B-OBJ I-OBJ I-OBJ I-OBJ I-OBJ I-OBJ I-OBJ O O O O O B-SUB I-SUB I-SUB	任职
B-OBJ I-OBJ I-OBJ O O O B-SUB I-SUB I-SUB O O	任职
B-OBJ I-OBJ I-OBJ O O B-SUB I-SUB I-SUB	任职
O B-OBJ I-OBJ I-OBJ I-OBJ I-OBJ I-OBJ I-OBJ I-OBJ O O B-SUB I-SUB I-SUB O O	任职
B-OBJ I-OBJ I-OBJ O O O O O O O O O O O B-SUB I-SUB I-SUB O O O O O	任职
B-OBJ I-OBJ I-OBJ I-OBJ I-OBJ I-OBJ O O B-SUB I-SUB I-SUB O O O O O O O O O	任职
O O B-OBJ I-OBJ I-OBJ O O O O O B-SUB I-SUB I-SUB O O O O O O	任职
B-OBJ I-OBJ I-OBJ I-OBJ I-OBJ O O O B-SUB I-SUB I-SUB O O O	任职
B-OBJ I-OBJ I-OBJ I-OBJ I-OBJ I-OBJ I-OBJ O O B-SUB I-SUB I-SUB O O O O O O O O O	任职
B-OBJ I-OBJ I-OBJ I-OBJ I-OBJ O O B-SUB I-SUB I-SUB O	任职
B-OBJ I-OBJ I-OBJ I-OBJ I-OBJ O O O O B-SUB I-SUB I-SUB	任职
B-OBJ I-OBJ I-OBJ O O O O B-SUB I-SUB I-SUB	任职
O B-OBJ I-OBJ I-OBJ O O O O O O O O B-SUB I-SUB I-SUB O O O O O O O O O O O O O O O O O	任职
B-OBJ I-OBJ I-OBJ I-OBJ I-OBJ O O B-SUB I-SUB I-SUB O O O O O O O	任职
B-OBJ I-OBJ I-OBJ O O O B-SUB I-SUB I-SUB O O O O O	任职
O O O O O O O O O B-OBJ I-OBJ O O O O O B-SUB I-SUB I-SUB O O O O O O	任职
B-OBJ I-OBJ I-OBJ I-OBJ I-OBJ I-OBJ I-OBJ I-OBJ I-OBJ I-OBJ O O B-SUB I-SUB I-SUB	任职
B-OBJ I-OBJ I-OBJ O O O O B-SUB I-SUB I-SUB O O O O O O O O O	任职
B-OBJ I-OBJ I-OBJ O O O B-SUB I-SUB I-SUB O O O O	任职
B-OBJ I-OBJ O O O O O O O O O B-SUB I-SUB I-SUB I-SUB O O O O O O O O O	任职
B-OBJ I-OBJ O O B-SUB I-SUB I-SUB I-SUB I-SUB I-SUB I-SUB	任职
B-OBJ I-OBJ I-OBJ O O O O O B-SUB I-SUB I-SUB I-SUB	任职
B-OBJ I-OBJ I-OBJ I-OBJ O O O B-SUB I-SUB I-SUB I-SUB I-SUB I-SUB I-SUB	任职
B-OBJ I-OBJ O O O B-SUB I-SUB I-SUB O O O O	任职
B-OBJ I-OBJ I-OBJ I-OBJ I-OBJ I-OBJ I-OBJ O O B-SUB I-SUB I-SUB	任职
B-OBJ I-OBJ O O B-SUB I-SUB I-SUB	任职
B-OBJ I-OBJ I-OBJ I-OBJ O O B-SUB I-SUB I-SUB I-SUB I-SUB	任职
B-SUB I-SUB O B-OBJ I-OBJ O O O O O O O O O O O O	任职
B-OBJ I-OBJ O O B-SUB I-SUB I-SUB I-SUB I-SUB I-SUB I-SUB	任职
O O B-OBJ I-OBJ I-OBJ I-OBJ I-OBJ I-OBJ I-OBJ O O B-SUB I-SUB I-SUB	任职
B-OBJ I-OBJ O O O O O O O O O O O O O O O O B-SUB I-SUB I-SUB I-SUB I-SUB I-SUB I-SUB I-SUB I-SUB	任职
B-OBJ I-OBJ B-SUB I-SUB I-SUB O O	任职
B-SUB I-SUB I-SUB O O O O O B-OBJ I-OBJ O O O O O O O O	任职
B-OBJ I-OBJ O O O O O B-SUB I-SUB I-SUB	任职
B-OBJ I-OBJ O O O B-SUB I-SUB I-SUB	任职
B-OBJ I-OBJ I-OBJ I-OBJ O O B-SUB I-SUB I-SUB	任职
B-OBJ I-OBJ O O O O B-SUB I-SUB I-SUB I-SUB I-SUB I-SUB I-SUB I-SUB I-SUB I-SUB I-SUB I-SUB	任职
B-OBJ I-OBJ O O B-SUB I-SUB I-SUB	任职
B-OBJ I-OBJ B-SUB I-SUB I-SUB O O O O O	任职
B-OBJ I-OBJ O O B-SUB I-SUB I-SUB I-SUB I-SUB I-SUB I-SUB	任职
B-OBJ I-OBJ O O O O O O B-SUB I-SUB I-SUB	任职
B-OBJ I-OBJ O O O O O O B-SUB I-SUB I-SUB	任职
B-OBJ I-OBJ O O O O B-SUB I-SUB I-SUB I-SUB I-SUB I-SUB I-SUB	任职
O O B-OBJ I-OBJ O O O O O O O B-SUB I-SUB I-SUB O O O O O O O O O O O O O O O O O O O O O O O O O O O O O O O O O O O O O	任职
B-OBJ I-OBJ O O O O B-SUB I-SUB I-SUB	任职
B-OBJ I-OBJ I-OBJ O O O O B-SUB I-SUB	任职
B-OBJ I-OBJ I-OBJ O O O B-SUB I-SUB I-SUB	任职
B-OBJ I-OBJ O O B-SUB I-SUB I-SUB	任职
B-OBJ I-OBJ I-OBJ O O O B-SUB I-SUB I-SUB	任职
B-OBJ I-OBJ O O B-SUB I-SUB I-SUB	任职
B-OBJ I-OBJ I-OBJ O O O B-SUB I-SUB I-SUB O O O O	任职
B-OBJ I-OBJ O O O O O O O O O B-SUB I-SUB I-SUB I-SUB O O O O O O O O O	任职
B-OBJ I-OBJ I-OBJ O O O O O B-SUB I-SUB I-SUB O O O O O O O O O O O O	任职
O O B-OBJ I-OBJ I-OBJ O O O B-SUB I-SUB I-SUB O O O O O	任职
B-OBJ I-OBJ I-OBJ I-OBJ I-OBJ I-OBJ O O O O O O O O O O O O B-SUB I-SUB I-SUB O O O O O	任职
B-OBJ I-OBJ I-OBJ O O O O O O O O O O O O O O O B-SUB I-SUB I-SUB O O O O O	任职
B-OBJ I-OBJ I-OBJ I-OBJ I-OBJ O O O B-SUB I-SUB I-SUB O O O O O O O O O O	任职
B-OBJ I-OBJ I-OBJ I-OBJ I-OBJ I-OBJ I-OBJ O O O O O B-SUB I-SUB I-SUB O O O O O	任职
O B-OBJ I-OBJ I-OBJ O O O O O B-SUB I-SUB O O O O O O O O O O O O O	任职
O O B-OBJ I-OBJ I-OBJ O O B-SUB I-SUB I-SUB O O O O O O O O O O [##WordPiece] [##WordPiece] O O O O O O O O O O O O O [##WordPiece] [##WordPiece] O O O	任职
O O O O O O B-OBJ I-OBJ O B-SUB I-SUB I-SUB O O O O	任职
B-OBJ I-OBJ I-OBJ I-OBJ I-OBJ I-OBJ I-OBJ I-OBJ O O B-SUB I-SUB O O O O O O O O O	任职
B-OBJ I-OBJ I-OBJ O O B-SUB I-SUB I-SUB O O O O O O O O O O O O O	任职
B-OBJ I-OBJ I-OBJ O O O O O B-SUB I-SUB I-SUB O O O O O	任职
O O B-OBJ I-OBJ I-OBJ O O O O B-SUB I-SUB I-SUB O O O O O O O O O O O	任职
O O B-OBJ I-OBJ I-OBJ O O B-SUB I-SUB I-SUB O O O O	任职
B-OBJ I-OBJ I-OBJ I-OBJ I-OBJ I-OBJ O O O O O O O O O O O O O O O O B-SUB I-SUB I-SUB O O O O O O O O O O O O O O O O O O O O O O O O	任职
B-OBJ I-OBJ I-OBJ I-OBJ I-OBJ I-OBJ O O O O O O O O O O O O O O O O O O O O B-SUB I-SUB I-SUB O O O O O O O O O O O O O O O O O O O O	任职
O B-OBJ I-OBJ O B-SUB I-SUB I-SUB O O O	任职
B-OBJ I-OBJ I-OBJ O O O B-SUB I-SUB I-SUB O O O O O O O	任职
B-OBJ I-OBJ O O O O O O B-SUB I-SUB I-SUB O O O O	任职
B-OBJ I-OBJ I-OBJ I-OBJ I-OBJ O O O O O O O O O O O O O O O O O O O O O O O O O O O B-SUB I-SUB I-SUB O O O O O	任职
O O B-OBJ I-OBJ O O O O O B-SUB I-SUB I-SUB O O O O O O O O O O O O O O O O O O O O O O O O O O O O O O O O O O O O O O	任职
B-OBJ I-OBJ I-OBJ I-OBJ I-OBJ I-OBJ I-OBJ I-OBJ I-OBJ O O O O O O O O O B-SUB I-SUB I-SUB O O O O O O O O O O O O O	任职
B-OBJ I-OBJ I-OBJ O O O O O O O O O O O O O O O B-SUB I-SUB I-SUB O O O O O O O O O O O O O	任职
B-OBJ I-OBJ O O O O O B-SUB I-SUB I-SUB O O O O O O O O O O O O O	任职
B-OBJ I-OBJ I-OBJ I-OBJ I-OBJ I-OBJ I-OBJ I-OBJ I-OBJ O O B-SUB I-SUB I-SUB O O	任职
B-OBJ I-OBJ O O B-SUB I-SUB I-SUB I-SUB I-SUB I-SUB I-SUB I-SUB I-SUB I-SUB [##WordPiece] I-SUB [##WordPiece] I-SUB [##WordPiece] [##WordPiece] [##WordPiece] [##WordPiece] I-SUB I-SUB I-SUB O O O O O O O O O	任职
B-OBJ I-OBJ I-OBJ I-OBJ O O B-SUB I-SUB I-SUB I-SUB I-SUB I-SUB I-SUB I-SUB I-SUB I-SUB I-SUB I-SUB I-SUB I-SUB [##WordPiece] I-SUB [##WordPiece] [##WordPiece] I-SUB [##WordPiece] [##WordPiece] [##WordPiece] I-SUB [##WordPiece] [##WordPiece] [##WordPiece] I-SUB O O O O	任职
O O O O O B-OBJ I-OBJ O B-SUB I-SUB I-SUB O O	任职
O B-OBJ I-OBJ O O O O O B-SUB I-SUB I-SUB O O O O	任职
O O B-OBJ I-OBJ I-OBJ O O O B-SUB I-SUB I-SUB O O O O	任职
O O O O O O O O O O O B-OBJ I-OBJ I-OBJ O O O O O B-SUB I-SUB I-SUB O O O O O O	任职
B-OBJ I-OBJ O O O O O O B-SUB I-SUB I-SUB O O O O O O O O O O O O O	任职
B-OBJ I-OBJ I-OBJ O O O B-SUB I-SUB I-SUB O O O O O O O	任职
B-OBJ I-OBJ O O O O O B-SUB I-SUB I-SUB O O O O O O O O O	任职
B-OBJ I-OBJ I-OBJ I-OBJ I-OBJ I-OBJ I-OBJ O O O O O O O O O O O O B-SUB I-SUB I-SUB O O O O O O O O O	任职
O O O O O O O O O O O O O O O O O O O O O O O O O O O O O O B-OBJ I-OBJ O O O O O B-SUB I-SUB I-SUB O O O O O O O	任职
O O O O O B-OBJ I-OBJ I-OBJ O O B-SUB I-SUB I-SUB O O O O O	任职
O O O O O B-OBJ I-OBJ I-OBJ O O O O O B-SUB I-SUB I-SUB O O O O O O O O O O O O	任职
O O B-OBJ I-OBJ I-OBJ O O O B-SUB I-SUB I-SUB O O O O	任职
B-OBJ I-OBJ I-OBJ I-OBJ I-OBJ I-OBJ O O O B-SUB I-SUB I-SUB O O O O O O O O O O O	任职
O O O B-OBJ I-OBJ I-OBJ O O O B-SUB I-SUB I-SUB O O O O O O	任职
B-OBJ I-OBJ O O O O O O B-SUB I-SUB I-SUB O O O O O O O O O O O O O O O O O O O O O O O O O O	任职
O O O B-OBJ I-OBJ O O O O O B-SUB I-SUB I-SUB O O O O O O O	任职
O O B-OBJ I-OBJ O O O O O B-SUB I-SUB I-SUB O O O O O O O O	任职
O O O O O B-OBJ I-OBJ I-OBJ O O O O O B-SUB I-SUB I-SUB O O O O O O O O O O O O	任职
O B-OBJ I-OBJ O O O O O O O O B-SUB I-SUB I-SUB O O O O O O O O O O O O O O O O O O O O O O O O	任职
O O O O O O O O O O O O O O O O B-OBJ I-OBJ I-OBJ B-SUB I-SUB I-SUB O O O O O O O O O O O O O O O O	任职
O O O O O O O O O O O O O O O O O O O O O O O B-OBJ I-OBJ I-OBJ O B-SUB I-SUB I-SUB O O O O O O O O	任职
O O O O O O O B-OBJ I-OBJ I-OBJ O O O O B-SUB I-SUB I-SUB O O	任职
B-OBJ I-OBJ O O O O O B-SUB I-SUB I-SUB O O O O O O	任职
B-OBJ I-OBJ O O O O O B-SUB I-SUB I-SUB O O O O O O O O O	任职
B-OBJ I-OBJ I-OBJ O O O O O B-SUB I-SUB I-SUB O O O O O O O O O O O O O O	任职
O O O O O O O O O O B-OBJ I-OBJ O O O B-SUB I-SUB I-SUB O O O O O O O O	任职
O O B-SUB I-SUB I-SUB O O O O B-OBJ I-OBJ O O O O O O O O O O	任职
O O O O O O O O O B-OBJ I-OBJ O O O O O O O O O O O O O O O O O O O O O O O O O O B-SUB I-SUB I-SUB O O O O O O O O O O O O	任职
O O O O O O O O O B-OBJ I-OBJ O O O O O O O O O O O O O O O O O O O O O O O O O O O O O O O O O O O O O B-SUB I-SUB I-SUB O	任职
B-OBJ I-OBJ I-OBJ O O B-SUB I-SUB I-SUB O O O O O O O O O O O O O O O O	任职
B-OBJ I-OBJ O O O O B-SUB I-SUB I-SUB O O O O O O O O	任职
B-OBJ I-OBJ I-OBJ I-OBJ I-OBJ O O O B-SUB I-SUB I-SUB O O O O O O	任职
B-OBJ I-OBJ I-OBJ O O O B-SUB I-SUB I-SUB O O O O	任职
B-OBJ I-OBJ O O O O O O B-SUB I-SUB I-SUB O O O O O O O O O O O O O O	任职
B-OBJ I-OBJ I-OBJ O O O B-SUB I-SUB I-SUB O O O	任职
O O B-OBJ I-OBJ I-OBJ O O O O B-SUB I-SUB I-SUB O O O O O O O	任职
B-OBJ I-OBJ I-OBJ O O O O O B-SUB I-SUB I-SUB O O O O O O O O O O O O O O O O O O	任职
B-OBJ I-OBJ I-OBJ I-OBJ I-OBJ I-OBJ I-OBJ O O O O O B-SUB I-SUB I-SUB O O O O O O O O O	任职
O B-OBJ I-OBJ I-OBJ O O O O O B-SUB I-SUB I-SUB O O O O O O O O O O O O O O O O O O O O O O O O O O O O	任职
B-OBJ I-OBJ I-OBJ I-OBJ O O O O O B-SUB I-SUB I-SUB O O O O O O O O O O O O O O O O O O O O O O O O O O O O O O O O O O O O O O O O O O O O O O O O O O O	任职
B-OBJ I-OBJ I-OBJ O O O B-SUB I-SUB I-SUB O O O O O O O O	任职
O O B-OBJ I-OBJ I-OBJ O O O O B-SUB I-SUB I-SUB O O O O O O O	任职
B-OBJ I-OBJ I-OBJ O O O B-SUB I-SUB I-SUB O O O O O O O O O O O	任职
O O O O O O O O O B-OBJ I-OBJ O O O B-SUB I-SUB I-SUB O O O O O O	任职
B-OBJ I-OBJ O O O O O O B-SUB I-SUB I-SUB O O O O O O O O O O O O O O O O O O O O O O O O O O O	任职
B-OBJ I-OBJ O O O O O O O O O O O O O B-SUB I-SUB I-SUB O O O O O O O O O O O O O O O O O O O O	任职
B-OBJ I-OBJ O O O O O O O O O O O O O O O O O O O O O O B-SUB I-SUB I-SUB O O O O O O O O O O O	任职
B-OBJ I-OBJ I-OBJ O O O O O B-SUB I-SUB I-SUB O O O O	任职
O O O O O O O O O O O O O O O O O O O O O O O O O B-OBJ I-OBJ O B-SUB I-SUB I-SUB O O O	任职
O O O O O B-OBJ I-OBJ I-OBJ O O O O B-SUB I-SUB I-SUB O	任职
B-SUB I-SUB I-SUB O O O B-OBJ I-OBJ O O O O O O O O O	任职
B-OBJ I-OBJ I-OBJ O O O O O O O O O B-SUB I-SUB I-SUB O O O O O O O O O O O O	任职
B-OBJ I-OBJ I-OBJ O O O O O B-SUB I-SUB I-SUB O O O O O O O O O O O	任职
B-OBJ I-OBJ I-OBJ I-OBJ I-OBJ O O O B-SUB I-SUB I-SUB O O O	任职
O O O O O O B-OBJ I-OBJ I-OBJ O B-SUB I-SUB I-SUB O O	任职
B-OBJ I-OBJ I-OBJ I-OBJ I-OBJ I-OBJ I-OBJ O O O O O O O O O B-SUB I-SUB O O O O O O O O O O O O O O O O O O O O O O O	任职
O O O O O O O O O O B-OBJ I-OBJ I-OBJ I-OBJ O O B-SUB I-SUB O O O O O O O O O O O O O O O O O O O O O O O	任职
B-OBJ I-OBJ I-OBJ O O O B-SUB I-SUB I-SUB O O	任职
O O O O B-OBJ I-OBJ I-OBJ O O O B-SUB I-SUB I-SUB O O O O	任职
B-OBJ I-OBJ I-OBJ I-OBJ I-OBJ I-OBJ O O B-SUB I-SUB I-SUB O O O	任职
B-OBJ I-OBJ I-OBJ I-OBJ I-OBJ I-OBJ I-OBJ O O O O O B-SUB I-SUB I-SUB O O O O O O O O O O O O O O O O O O O O	任职
B-OBJ I-OBJ I-OBJ I-OBJ I-OBJ O O O O O B-SUB I-SUB O O O O O O O	任职
B-OBJ I-OBJ I-OBJ I-OBJ I-OBJ I-OBJ I-OBJ I-OBJ O O B-SUB I-SUB I-SUB I-SUB O O	任职
B-OBJ I-OBJ I-OBJ O O B-SUB I-SUB I-SUB O O	任职
B-OBJ I-OBJ I-OBJ I-OBJ I-OBJ I-OBJ I-OBJ I-OBJ I-OBJ I-OBJ I-OBJ O O B-SUB I-SUB I-SUB O O O O O O O O O O O O O O O O O O	任职
B-OBJ I-OBJ O O O O O B-SUB I-SUB I-SUB O O O O O O O O O O O O O O O	任职
B-OBJ I-OBJ I-OBJ I-OBJ I-OBJ O O O B-SUB I-SUB I-SUB O O O O O	任职
B-OBJ I-OBJ I-OBJ I-OBJ I-OBJ I-OBJ I-OBJ I-OBJ I-OBJ O O O B-SUB I-SUB I-SUB O O O O O O	任职
B-OBJ I-OBJ O O O O O B-SUB I-SUB I-SUB O O O O O O O	任职
B-OBJ I-OBJ I-OBJ O O O B-SUB I-SUB I-SUB O O O O O O	任职
B-OBJ [##WordPiece] I-OBJ I-OBJ I-OBJ I-OBJ I-OBJ O O B-SUB I-SUB I-SUB O O O O O O O O O O O O	任职
B-OBJ I-OBJ I-OBJ O O B-SUB I-SUB O O O O O O O O O O O	任职
O O O O O O O O O O O B-SUB I-SUB I-SUB O O O O O O B-OBJ I-OBJ I-OBJ O O	任职
B-OBJ I-OBJ I-OBJ I-OBJ I-OBJ O O O B-SUB I-SUB I-SUB O O O	任职
B-OBJ I-OBJ I-OBJ I-OBJ I-OBJ I-OBJ O O B-SUB I-SUB I-SUB O	任职
B-OBJ I-OBJ I-OBJ I-OBJ I-OBJ I-OBJ O O O B-SUB I-SUB I-SUB O O O	任职
O O O O O B-OBJ I-OBJ I-OBJ I-OBJ I-OBJ I-OBJ I-OBJ O O B-SUB I-SUB I-SUB O O O O O O O O O O	任职
B-OBJ I-OBJ I-OBJ I-OBJ O O O O O B-SUB I-SUB I-SUB O O O O O O	任职
O O O O O O O B-OBJ I-OBJ I-OBJ I-OBJ I-OBJ O O B-SUB I-SUB O O O O O O O O O O O O O O O O O O O O O O O O O	任职
B-OBJ I-OBJ O O O O O B-SUB I-SUB I-SUB O O O O O O O O O O	任职
B-OBJ I-OBJ I-OBJ O O B-SUB I-SUB I-SUB O O O O O O	任职
B-OBJ I-OBJ I-OBJ O O O B-SUB I-SUB I-SUB O O O O	任职
B-OBJ I-OBJ I-OBJ I-OBJ I-OBJ O B-SUB I-SUB O O	任职
B-OBJ I-OBJ I-OBJ I-OBJ I-OBJ I-OBJ O O B-SUB I-SUB I-SUB O	任职
B-OBJ I-OBJ O O O O O B-SUB I-SUB I-SUB O O O O O O O O O O	任职
O O B-OBJ I-OBJ I-OBJ I-OBJ I-OBJ O B-SUB I-SUB O O O O O O O	任职
B-OBJ I-OBJ I-OBJ I-OBJ I-OBJ O O O B-SUB I-SUB I-SUB O O O O O O O O O O O O O O	任职
B-OBJ I-OBJ I-OBJ O O O B-SUB I-SUB I-SUB O O O O O O O O O O O O	任职
B-OBJ I-OBJ O O O O O B-SUB I-SUB I-SUB O O O O O O O O O	任职
O O O O O O O O O O B-SUB I-SUB I-SUB O O B-OBJ I-OBJ I-OBJ I-OBJ I-OBJ I-OBJ O O O O O	任职
B-OBJ I-OBJ I-OBJ O O O B-SUB I-SUB I-SUB O O O O O O O O O O O O O O O O O O O	任职
B-OBJ I-OBJ I-OBJ I-OBJ I-OBJ I-OBJ I-OBJ I-OBJ I-OBJ I-OBJ I-OBJ I-OBJ I-OBJ I-OBJ I-OBJ O O O O B-SUB I-SUB	任职
O O B-OBJ I-OBJ O O B-SUB I-SUB I-SUB O O O O O O O O O	任职
B-OBJ I-OBJ I-OBJ O O O B-SUB I-SUB I-SUB O O O O O O	任职
B-OBJ I-OBJ I-OBJ O O O B-SUB I-SUB O O O O	任职
B-OBJ I-OBJ O O O O O B-SUB I-SUB I-SUB O O O O O O O O O O O O O O O O O O O O O O O O O O	任职
B-OBJ I-OBJ I-OBJ O O O B-SUB I-SUB I-SUB O O O O O O	任职
B-OBJ I-OBJ I-OBJ I-OBJ O O O B-SUB I-SUB I-SUB	任职
O O O O B-OBJ I-OBJ O O B-SUB I-SUB I-SUB O O O O	任职
O O O B-OBJ I-OBJ I-OBJ O O B-SUB I-SUB I-SUB O O O O O O O O O	任职
B-OBJ I-OBJ I-OBJ O O B-SUB I-SUB I-SUB O O O O O O O O O O O	任职
B-OBJ I-OBJ O O O O O B-SUB I-SUB I-SUB O O O O O O O	任职
O O O O B-OBJ I-OBJ I-OBJ O O O O O B-SUB I-SUB I-SUB O O O O O O O O O	任职
O O O O B-OBJ I-OBJ I-OBJ I-OBJ I-OBJ I-OBJ I-OBJ I-OBJ I-OBJ I-OBJ I-OBJ I-OBJ I-OBJ O O B-SUB I-SUB I-SUB	任职
B-OBJ I-OBJ I-OBJ I-OBJ I-OBJ O O O B-SUB I-SUB I-SUB O O O O	任职
B-OBJ I-OBJ I-OBJ I-OBJ I-OBJ O O O B-SUB I-SUB I-SUB O O O O O O O O O O O O O O	任职
O O O O O O O O B-OBJ I-OBJ I-OBJ O O O B-SUB I-SUB I-SUB I-SUB	任职
B-OBJ I-OBJ O O O B-SUB I-SUB I-SUB O O O O O O O O O O O O	任职
B-OBJ I-OBJ I-OBJ I-OBJ I-OBJ O O O B-SUB I-SUB I-SUB O O	任职
O O O O O B-OBJ I-OBJ I-OBJ O B-SUB I-SUB O O O O O O O O O O O O O O O O O O O O O O O O	任职
B-OBJ I-OBJ I-OBJ I-OBJ I-OBJ O O O O O B-SUB I-SUB I-SUB I-SUB I-SUB I-SUB O O O O O O	任职
B-OBJ I-OBJ O O B-SUB I-SUB I-SUB O O O O O O O O O O	任职
B-OBJ I-OBJ O O O B-SUB I-SUB I-SUB O O O O O O O O O O O O O O O O O O O O	任职
B-OBJ I-OBJ I-OBJ I-OBJ I-OBJ O O O B-SUB I-SUB I-SUB O O O	任职
B-OBJ I-OBJ O O O B-SUB I-SUB I-SUB O O O O O O O O O	任职
B-OBJ I-OBJ I-OBJ I-OBJ I-OBJ I-OBJ I-OBJ I-OBJ I-OBJ I-OBJ O O O B-SUB I-SUB I-SUB O O O O O O O O O O O O O	任职
B-OBJ I-OBJ I-OBJ I-OBJ I-OBJ I-OBJ I-OBJ B-SUB I-SUB O O O O O O O O O O O O O O O O O O O O O O O O O	任职
B-OBJ I-OBJ I-OBJ O O O B-SUB I-SUB I-SUB O O O	任职
B-OBJ I-OBJ I-OBJ O O O B-SUB I-SUB I-SUB O O O O	任职
B-OBJ I-OBJ I-OBJ I-OBJ I-OBJ O B-SUB I-SUB I-SUB O O O O O O O O O O O O O O O O O O O O O O O O O O O	任职
B-OBJ I-OBJ I-OBJ O O O B-SUB I-SUB I-SUB O O O O O O O	任职
B-OBJ I-OBJ I-OBJ I-OBJ I-OBJ I-OBJ I-OBJ I-OBJ O O B-SUB I-SUB O	任职
B-OBJ I-OBJ O O B-SUB I-SUB I-SUB O O O O O O O O O O O O O O O O O O O O	任职
O B-OBJ I-OBJ I-OBJ I-OBJ I-OBJ O O O B-SUB I-SUB I-SUB O O O O O O O O O O O O O O O O O O O O O O O O	任职
B-OBJ I-OBJ I-OBJ O O O B-SUB I-SUB I-SUB O O O O O O O	任职
B-OBJ I-OBJ O O B-SUB I-SUB I-SUB O O O O	任职
B-OBJ I-OBJ I-OBJ I-OBJ I-OBJ O O O B-SUB I-SUB I-SUB I-SUB O O O O	任职
B-OBJ I-OBJ O O B-SUB I-SUB I-SUB O O O O O O O O O O O O O O O O O O O O O O O O O O O O	任职
O O B-OBJ I-OBJ O O O B-SUB I-SUB I-SUB O O O O O O O O O O O O O O O O O O O O	任职
B-OBJ I-OBJ I-OBJ I-OBJ I-OBJ O O O B-SUB I-SUB I-SUB I-SUB O O O O	任职
B-OBJ I-OBJ O O O O B-SUB I-SUB I-SUB O O O O O O O O O O O O O O O O O O O O O O O	任职
B-OBJ I-OBJ I-OBJ I-OBJ I-OBJ O B-SUB I-SUB I-SUB O O O O O O O O O	任职
B-OBJ I-OBJ O O O B-SUB I-SUB I-SUB O O O O O O O O O O O O O O O O O O O O O O O O O O O O	任职
B-OBJ I-OBJ O O B-SUB I-SUB I-SUB O O O O O O O	任职
B-OBJ I-OBJ O O B-SUB I-SUB I-SUB O O O O O O O O O O O O O O O O O O O	任职
B-OBJ I-OBJ I-OBJ I-OBJ I-OBJ I-OBJ I-OBJ I-OBJ O O O B-SUB I-SUB I-SUB I-SUB I-SUB I-SUB O O [##WordPiece] [##WordPiece] O [##WordPiece] O O O	任职
B-OBJ I-OBJ I-OBJ I-OBJ I-OBJ I-OBJ I-OBJ O O [##WordPiece] O O O B-SUB I-SUB I-SUB I-SUB I-SUB I-SUB I-SUB I-SUB O O [##WordPiece] [##WordPiece] O [##WordPiece] [##WordPiece] [##WordPiece] O O O	任职
O O O O O O B-OBJ I-OBJ I-OBJ O O O B-SUB I-SUB I-SUB I-SUB	任职
B-OBJ I-OBJ O O B-SUB I-SUB I-SUB O O O O O O	任职
B-OBJ I-OBJ I-OBJ I-OBJ I-OBJ I-OBJ I-OBJ O O O O O O O B-SUB I-SUB I-SUB O O O O	任职
B-OBJ I-OBJ O O O B-SUB I-SUB I-SUB O O O O	任职
O O B-OBJ I-OBJ I-OBJ I-OBJ I-OBJ I-OBJ O O O O O B-SUB I-SUB I-SUB O O O O O O O O O O O O	任职
B-OBJ I-OBJ I-OBJ I-OBJ I-OBJ O O O B-SUB I-SUB I-SUB O O O O	任职
B-OBJ I-OBJ I-OBJ O O O B-SUB I-SUB I-SUB I-SUB O O O O	任职
B-OBJ I-OBJ O O B-SUB I-SUB I-SUB O O O O O O O O O O O O O	任职
B-OBJ I-OBJ O O O B-SUB I-SUB O O O O O O O	任职
B-OBJ I-OBJ O O O B-SUB I-SUB I-SUB O O O O O O O O O O O O O O O O O O O O O O O O O O O O O O	任职
B-OBJ I-OBJ I-OBJ I-OBJ I-OBJ I-OBJ O B-SUB I-SUB I-SUB I-SUB O O O O O O O O O O O O O O O O O O O O O O O O O O O O	任职
B-OBJ I-OBJ I-OBJ I-OBJ I-OBJ O O B-SUB I-SUB I-SUB I-SUB I-SUB O O O O O O O O O O O O O O O O O O O O O O O O O O O O O O O O O O O O O O O O O O	任职
B-OBJ I-OBJ O O O B-SUB I-SUB I-SUB O O O O O O O O O O O O	任职
B-OBJ I-OBJ O O B-SUB I-SUB I-SUB O O O O O O O O	任职
B-OBJ I-OBJ I-OBJ I-OBJ I-OBJ I-OBJ O B-SUB I-SUB I-SUB I-SUB O O O O O O O O O O O O O O	任职
O B-OBJ I-OBJ O O B-SUB I-SUB I-SUB O O O O O O O O O O [##WordPiece] [##WordPiece] O O	任职
B-OBJ I-OBJ I-OBJ O O O B-SUB I-SUB I-SUB O O O O	任职
B-SUB I-SUB I-SUB I-SUB O B-OBJ I-OBJ I-OBJ I-OBJ I-OBJ O O O O O O O O O O O O O O O O	任职
O O B-OBJ I-OBJ O O O B-SUB I-SUB I-SUB O O O O O O O O O O O O O O O O O	任职
B-OBJ I-OBJ I-OBJ I-OBJ I-OBJ O O O B-SUB I-SUB I-SUB O O O O O O O O O O O O O O O O O O	任职
B-OBJ I-OBJ I-OBJ I-OBJ I-OBJ I-OBJ O B-SUB I-SUB I-SUB I-SUB O O O O O O O O O O O O O O	任职
B-OBJ I-OBJ I-OBJ I-OBJ I-OBJ I-OBJ I-OBJ I-OBJ O O O O O O O B-SUB I-SUB I-SUB O O O	任职
O O O O O B-OBJ I-OBJ O O B-SUB I-SUB I-SUB O O O O O O O O O O O O O O O	任职
B-OBJ I-OBJ I-OBJ I-OBJ I-OBJ I-OBJ I-OBJ I-OBJ I-OBJ I-OBJ O O O O O B-SUB I-SUB I-SUB I-SUB I-SUB I-SUB O O O O O O O O O O O O	任职
B-OBJ I-OBJ I-OBJ I-OBJ I-OBJ I-OBJ I-OBJ I-OBJ I-OBJ I-OBJ I-OBJ I-OBJ O O B-SUB I-SUB I-SUB O O [##WordPiece] [##WordPiece] O [##WordPiece] [##WordPiece] O O O O O O O O O O O O O O	任职
B-OBJ I-OBJ O O B-SUB I-SUB I-SUB I-SUB O O O O O O O O O O O O O O O O O O O O O O O O O	任职
O O O O O O O O O O O O O O O O O O O O B-OBJ I-OBJ O O B-SUB I-SUB I-SUB O O O O O O	任职
